Zip Code,Date,Total Doses - Daily,Total Doses - Cumulative,1st Dose - Daily,1st Dose - Cumulative,1st Dose - Percent Population,Vaccine Series Completed - Daily,Vaccine Series Completed - Cumulative,Vaccine Series Completed  - Percent Population,Population,ZIP Code Location,Row_ID
60601,01/20/2021,57,1144,40,776,0.051,17,368,0.024,15083,POINT (-87.622844 41.886262),60601-20210120
60603,02/09/2021,12,448,10,358,0.34,2,90,0.086,1052,POINT (-87.625473 41.880112),60603-20210209
60603,02/10/2021,18,466,16,374,0.356,2,92,0.087,1052,POINT (-87.625473 41.880112),60603-20210210
60603,02/11/2021,6,472,0,374,0.356,6,98,0.093,1052,POINT (-87.625473 41.880112),60603-20210211
60603,02/12/2021,18,490,4,378,0.359,14,112,0.106,1052,POINT (-87.625473 41.880112),60603-20210212
60603,02/13/2021,7,497,4,382,0.363,3,115,0.109,1052,POINT (-87.625473 41.880112),60603-20210213
60603,02/14/2021,4,501,3,385,0.366,1,116,0.11,1052,POINT (-87.625473 41.880112),60603-20210214
60603,02/15/2021,4,505,2,387,0.368,2,118,0.112,1052,POINT (-87.625473 41.880112),60603-20210215
60605,01/22/2021,214,4248,193,2744,0.094,21,1504,0.052,29060,POINT (-87.623449 41.867824),60605-20210122
60605,01/23/2021,96,4344,83,2827,0.097,13,1517,0.052,29060,POINT (-87.623449 41.867824),60605-20210123
60605,01/24/2021,31,4375,30,2857,0.098,1,1518,0.052,29060,POINT (-87.623449 41.867824),60605-20210124
60605,01/25/2021,151,4526,83,2940,0.101,68,1586,0.055,29060,POINT (-87.623449 41.867824),60605-20210125
60605,01/26/2021,131,4657,72,3012,0.104,59,1645,0.057,29060,POINT (-87.623449 41.867824),60605-20210126
60605,01/27/2021,164,4821,128,3140,0.108,36,1681,0.058,29060,POINT (-87.623449 41.867824),60605-20210127
60605,01/28/2021,203,5024,159,3299,0.114,44,1725,0.059,29060,POINT (-87.623449 41.867824),60605-20210128
60605,01/29/2021,227,5251,188,3487,0.12,39,1764,0.061,29060,POINT (-87.623449 41.867824),60605-20210129
60605,01/30/2021,74,5325,51,3538,0.122,23,1787,0.061,29060,POINT (-87.623449 41.867824),60605-20210130
60605,01/31/2021,31,5356,24,3562,0.123,7,1794,0.062,29060,POINT (-87.623449 41.867824),60605-20210131
60605,02/01/2021,108,5464,73,3635,0.125,35,1829,0.063,29060,POINT (-87.623449 41.867824),60605-20210201
60605,02/02/2021,173,5637,99,3734,0.128,74,1903,0.065,29060,POINT (-87.623449 41.867824),60605-20210202
60605,02/03/2021,146,5783,104,3838,0.132,42,1945,0.067,29060,POINT (-87.623449 41.867824),60605-20210203
60605,02/04/2021,214,5997,168,4006,0.138,46,1991,0.069,29060,POINT (-87.623449 41.867824),60605-20210204
60605,02/05/2021,231,6228,182,4188,0.144,49,2040,0.07,29060,POINT (-87.623449 41.867824),60605-20210205
60605,02/06/2021,110,6338,70,4258,0.147,40,2080,0.072,29060,POINT (-87.623449 41.867824),60605-20210206
60605,02/07/2021,30,6368,26,4284,0.147,4,2084,0.072,29060,POINT (-87.623449 41.867824),60605-20210207
60605,02/08/2021,116,6484,74,4358,0.15,42,2126,0.073,29060,POINT (-87.623449 41.867824),60605-20210208
60602,01/13/2021,5,98,4,70,0.061,1,28,0.024,1145,POINT (-87.628309 41.883136),60602-20210113
60602,01/14/2021,8,106,6,76,0.066,2,30,0.026,1145,POINT (-87.628309 41.883136),60602-20210114
60602,01/15/2021,7,113,7,83,0.072,0,30,0.026,1145,POINT (-87.628309 41.883136),60602-20210115
60602,01/16/2021,7,120,7,90,0.079,0,30,0.026,1145,POINT (-87.628309 41.883136),60602-20210116
60602,01/17/2021,3,123,2,92,0.08,1,31,0.027,1145,POINT (-87.628309 41.883136),60602-20210117
60602,01/18/2021,8,131,6,98,0.086,2,33,0.029,1145,POINT (-87.628309 41.883136),60602-20210118
60602,01/19/2021,19,150,11,109,0.095,8,41,0.036,1145,POINT (-87.628309 41.883136),60602-20210119
60602,01/21/2021,14,174,13,130,0.114,1,44,0.038,1145,POINT (-87.628309 41.883136),60602-20210121
60602,01/22/2021,22,196,22,152,0.133,0,44,0.038,1145,POINT (-87.628309 41.883136),60602-20210122
60602,01/23/2021,10,206,10,162,0.141,0,44,0.038,1145,POINT (-87.628309 41.883136),60602-20210123
60602,01/24/2021,1,207,1,163,0.142,0,44,0.038,1145,POINT (-87.628309 41.883136),60602-20210124
60602,01/25/2021,11,218,9,172,0.15,2,46,0.04,1145,POINT (-87.628309 41.883136),60602-20210125
60602,01/26/2021,15,233,9,181,0.158,6,52,0.045,1145,POINT (-87.628309 41.883136),60602-20210126
60602,01/27/2021,11,244,8,189,0.165,3,55,0.048,1145,POINT (-87.628309 41.883136),60602-20210127
60602,01/28/2021,10,254,10,199,0.174,0,55,0.048,1145,POINT (-87.628309 41.883136),60602-20210128
60602,01/29/2021,13,267,12,211,0.184,1,56,0.049,1145,POINT (-87.628309 41.883136),60602-20210129
60602,01/30/2021,14,281,12,223,0.195,2,58,0.051,1145,POINT (-87.628309 41.883136),60602-20210130
60602,01/31/2021,1,282,0,223,0.195,1,59,0.052,1145,POINT (-87.628309 41.883136),60602-20210131
60602,02/01/2021,13,295,12,235,0.205,1,60,0.052,1145,POINT (-87.628309 41.883136),60602-20210201
60602,02/02/2021,14,309,9,244,0.213,5,65,0.057,1145,POINT (-87.628309 41.883136),60602-20210202
60602,02/03/2021,20,329,16,260,0.227,4,69,0.06,1145,POINT (-87.628309 41.883136),60602-20210203
60602,02/04/2021,19,348,17,277,0.242,2,71,0.062,1145,POINT (-87.628309 41.883136),60602-20210204
60602,02/05/2021,13,361,12,289,0.252,1,72,0.063,1145,POINT (-87.628309 41.883136),60602-20210205
60602,02/06/2021,8,369,3,292,0.255,5,77,0.067,1145,POINT (-87.628309 41.883136),60602-20210206
60602,02/07/2021,2,371,1,293,0.256,1,78,0.068,1145,POINT (-87.628309 41.883136),60602-20210207
60605,02/09/2021,114,6598,69,4427,0.152,45,2171,0.075,29060,POINT (-87.623449 41.867824),60605-20210209
60605,02/10/2021,210,6808,154,4581,0.158,56,2227,0.077,29060,POINT (-87.623449 41.867824),60605-20210210
60605,02/11/2021,194,7002,75,4656,0.16,119,2346,0.081,29060,POINT (-87.623449 41.867824),60605-20210211
60605,02/12/2021,257,7259,99,4755,0.164,158,2504,0.086,29060,POINT (-87.623449 41.867824),60605-20210212
60605,02/13/2021,122,7381,61,4816,0.166,61,2565,0.088,29060,POINT (-87.623449 41.867824),60605-20210213
60605,02/14/2021,30,7411,16,4832,0.166,14,2579,0.089,29060,POINT (-87.623449 41.867824),60605-20210214
60605,02/15/2021,76,7487,48,4880,0.168,28,2607,0.09,29060,POINT (-87.623449 41.867824),60605-20210215
60605,02/16/2021,152,7639,113,4993,0.172,39,2646,0.091,29060,POINT (-87.623449 41.867824),60605-20210216
60605,02/17/2021,157,7796,48,5041,0.173,109,2755,0.095,29060,POINT (-87.623449 41.867824),60605-20210217
60603,12/15/2020,0,0,0,0,0,0,0,0,1052,POINT (-87.625473 41.880112),60603-20201215
60603,12/16/2020,0,0,0,0,0,0,0,0,1052,POINT (-87.625473 41.880112),60603-20201216
60603,12/17/2020,8,8,8,8,0.008,0,0,0,1052,POINT (-87.625473 41.880112),60603-20201217
60603,12/18/2020,6,14,6,14,0.013,0,0,0,1052,POINT (-87.625473 41.880112),60603-20201218
60603,12/19/2020,4,18,4,18,0.017,0,0,0,1052,POINT (-87.625473 41.880112),60603-20201219
60603,12/20/2020,5,23,5,23,0.022,0,0,0,1052,POINT (-87.625473 41.880112),60603-20201220
60603,12/21/2020,5,28,5,28,0.027,0,0,0,1052,POINT (-87.625473 41.880112),60603-20201221
60603,12/22/2020,7,35,7,35,0.033,0,0,0,1052,POINT (-87.625473 41.880112),60603-20201222
60603,12/23/2020,0,35,0,35,0.033,0,0,0,1052,POINT (-87.625473 41.880112),60603-20201223
60603,12/24/2020,1,36,1,36,0.034,0,0,0,1052,POINT (-87.625473 41.880112),60603-20201224
60603,12/26/2020,0,36,0,36,0.034,0,0,0,1052,POINT (-87.625473 41.880112),60603-20201226
60603,12/28/2020,1,37,1,37,0.035,0,0,0,1052,POINT (-87.625473 41.880112),60603-20201228
60603,12/29/2020,2,39,2,39,0.037,0,0,0,1052,POINT (-87.625473 41.880112),60603-20201229
60603,12/30/2020,3,42,3,42,0.04,0,0,0,1052,POINT (-87.625473 41.880112),60603-20201230
60603,12/31/2020,1,43,1,43,0.041,0,0,0,1052,POINT (-87.625473 41.880112),60603-20201231
60603,01/01/2021,0,43,0,43,0.041,0,0,0,1052,POINT (-87.625473 41.880112),60603-20210101
60603,01/02/2021,0,43,0,43,0.041,0,0,0,1052,POINT (-87.625473 41.880112),60603-20210102
60603,01/03/2021,0,43,0,43,0.041,0,0,0,1052,POINT (-87.625473 41.880112),60603-20210103
60603,01/04/2021,2,45,2,45,0.043,0,0,0,1052,POINT (-87.625473 41.880112),60603-20210104
60603,01/05/2021,3,48,2,47,0.045,1,1,0.001,1052,POINT (-87.625473 41.880112),60603-20210105
60603,01/06/2021,1,49,1,48,0.046,0,1,0.001,1052,POINT (-87.625473 41.880112),60603-20210106
60603,01/07/2021,11,60,1,49,0.047,10,11,0.01,1052,POINT (-87.625473 41.880112),60603-20210107
60603,01/08/2021,9,69,2,51,0.048,7,18,0.017,1052,POINT (-87.625473 41.880112),60603-20210108
60603,01/09/2021,42,111,37,88,0.084,5,23,0.022,1052,POINT (-87.625473 41.880112),60603-20210109
60603,01/10/2021,3,114,1,89,0.085,2,25,0.024,1052,POINT (-87.625473 41.880112),60603-20210110
60603,01/11/2021,1,115,0,89,0.085,1,26,0.025,1052,POINT (-87.625473 41.880112),60603-20210111
60603,01/12/2021,7,122,1,90,0.086,6,32,0.03,1052,POINT (-87.625473 41.880112),60603-20210112
60603,01/13/2021,2,124,2,92,0.087,0,32,0.03,1052,POINT (-87.625473 41.880112),60603-20210113
60603,01/14/2021,5,129,4,96,0.091,1,33,0.031,1052,POINT (-87.625473 41.880112),60603-20210114
60603,01/15/2021,11,140,11,107,0.102,0,33,0.031,1052,POINT (-87.625473 41.880112),60603-20210115
60603,01/16/2021,35,175,35,142,0.135,0,33,0.031,1052,POINT (-87.625473 41.880112),60603-20210116
60603,01/17/2021,2,177,2,144,0.137,0,33,0.031,1052,POINT (-87.625473 41.880112),60603-20210117
60603,01/18/2021,3,180,3,147,0.14,0,33,0.031,1052,POINT (-87.625473 41.880112),60603-20210118
60603,01/19/2021,0,180,0,147,0.14,0,33,0.031,1052,POINT (-87.625473 41.880112),60603-20210119
60603,01/20/2021,7,187,7,154,0.146,0,33,0.031,1052,POINT (-87.625473 41.880112),60603-20210120
60603,01/21/2021,12,199,9,163,0.155,3,36,0.034,1052,POINT (-87.625473 41.880112),60603-20210121
60603,01/22/2021,23,222,23,186,0.177,0,36,0.034,1052,POINT (-87.625473 41.880112),60603-20210122
60603,01/23/2021,8,230,8,194,0.184,0,36,0.034,1052,POINT (-87.625473 41.880112),60603-20210123
60603,01/24/2021,2,232,1,195,0.185,1,37,0.035,1052,POINT (-87.625473 41.880112),60603-20210124
60603,01/25/2021,4,236,3,198,0.188,1,38,0.036,1052,POINT (-87.625473 41.880112),60603-20210125
60603,01/26/2021,6,242,4,202,0.192,2,40,0.038,1052,POINT (-87.625473 41.880112),60603-20210126
60603,01/27/2021,68,310,68,270,0.257,0,40,0.038,1052,POINT (-87.625473 41.880112),60603-20210127
60603,01/28/2021,9,319,7,277,0.263,2,42,0.04,1052,POINT (-87.625473 41.880112),60603-20210128
60603,01/29/2021,8,327,7,284,0.27,1,43,0.041,1052,POINT (-87.625473 41.880112),60603-20210129
60603,01/30/2021,9,336,8,292,0.278,1,44,0.042,1052,POINT (-87.625473 41.880112),60603-20210130
60603,01/31/2021,0,336,0,292,0.278,0,44,0.042,1052,POINT (-87.625473 41.880112),60603-20210131
60603,02/01/2021,3,339,2,294,0.279,1,45,0.043,1052,POINT (-87.625473 41.880112),60603-20210201
60603,02/02/2021,9,348,5,299,0.284,4,49,0.047,1052,POINT (-87.625473 41.880112),60603-20210202
60603,02/03/2021,18,366,17,316,0.3,1,50,0.048,1052,POINT (-87.625473 41.880112),60603-20210203
60603,02/04/2021,10,376,5,321,0.305,5,55,0.052,1052,POINT (-87.625473 41.880112),60603-20210204
60603,02/05/2021,13,389,7,328,0.312,6,61,0.058,1052,POINT (-87.625473 41.880112),60603-20210205
60603,02/06/2021,38,427,12,340,0.323,26,87,0.083,1052,POINT (-87.625473 41.880112),60603-20210206
60603,02/07/2021,2,429,2,342,0.325,0,87,0.083,1052,POINT (-87.625473 41.880112),60603-20210207
60603,02/08/2021,7,436,6,348,0.331,1,88,0.084,1052,POINT (-87.625473 41.880112),60603-20210208
60604,12/15/2020,0,0,0,0,0,0,0,0,823,POINT (-87.629029 41.878153),60604-20201215
60604,12/16/2020,0,0,0,0,0,0,0,0,823,POINT (-87.629029 41.878153),60604-20201216
60604,12/17/2020,0,0,0,0,0,0,0,0,823,POINT (-87.629029 41.878153),60604-20201217
60604,12/18/2020,5,5,5,5,0.006,0,0,0,823,POINT (-87.629029 41.878153),60604-20201218
60604,12/19/2020,0,5,0,5,0.006,0,0,0,823,POINT (-87.629029 41.878153),60604-20201219
60604,12/20/2020,0,5,0,5,0.006,0,0,0,823,POINT (-87.629029 41.878153),60604-20201220
60604,12/21/2020,0,5,0,5,0.006,0,0,0,823,POINT (-87.629029 41.878153),60604-20201221
60604,12/22/2020,0,5,0,5,0.006,0,0,0,823,POINT (-87.629029 41.878153),60604-20201222
60604,12/23/2020,1,6,1,6,0.007,0,0,0,823,POINT (-87.629029 41.878153),60604-20201223
60604,12/24/2020,1,7,1,7,0.009,0,0,0,823,POINT (-87.629029 41.878153),60604-20201224
60604,12/25/2020,0,7,0,7,0.009,0,0,0,823,POINT (-87.629029 41.878153),60604-20201225
60604,12/26/2020,0,7,0,7,0.009,0,0,0,823,POINT (-87.629029 41.878153),60604-20201226
60604,12/27/2020,0,7,0,7,0.009,0,0,0,823,POINT (-87.629029 41.878153),60604-20201227
60604,12/28/2020,1,8,1,8,0.01,0,0,0,823,POINT (-87.629029 41.878153),60604-20201228
60604,12/29/2020,1,9,1,9,0.011,0,0,0,823,POINT (-87.629029 41.878153),60604-20201229
60604,12/30/2020,1,10,1,10,0.012,0,0,0,823,POINT (-87.629029 41.878153),60604-20201230
60604,12/31/2020,1,11,1,11,0.013,0,0,0,823,POINT (-87.629029 41.878153),60604-20201231
60604,01/01/2021,0,11,0,11,0.013,0,0,0,823,POINT (-87.629029 41.878153),60604-20210101
60604,01/02/2021,0,11,0,11,0.013,0,0,0,823,POINT (-87.629029 41.878153),60604-20210102
60604,01/03/2021,0,11,0,11,0.013,0,0,0,823,POINT (-87.629029 41.878153),60604-20210103
60604,01/04/2021,1,12,1,12,0.015,0,0,0,823,POINT (-87.629029 41.878153),60604-20210104
60604,01/05/2021,2,14,2,14,0.017,0,0,0,823,POINT (-87.629029 41.878153),60604-20210105
60604,01/06/2021,1,15,1,15,0.018,0,0,0,823,POINT (-87.629029 41.878153),60604-20210106
60604,01/07/2021,3,18,1,16,0.019,2,2,0.002,823,POINT (-87.629029 41.878153),60604-20210107
60604,01/08/2021,4,22,2,18,0.022,2,4,0.005,823,POINT (-87.629029 41.878153),60604-20210108
60604,01/09/2021,2,24,1,19,0.023,1,5,0.006,823,POINT (-87.629029 41.878153),60604-20210109
60604,01/10/2021,0,24,0,19,0.023,0,5,0.006,823,POINT (-87.629029 41.878153),60604-20210110
60604,01/11/2021,1,25,1,20,0.024,0,5,0.006,823,POINT (-87.629029 41.878153),60604-20210111
60604,01/12/2021,0,25,0,20,0.024,0,5,0.006,823,POINT (-87.629029 41.878153),60604-20210112
60604,01/13/2021,10,35,9,29,0.035,1,6,0.007,823,POINT (-87.629029 41.878153),60604-20210113
60604,01/14/2021,4,39,3,32,0.039,1,7,0.009,823,POINT (-87.629029 41.878153),60604-20210114
60604,01/15/2021,3,42,3,35,0.043,0,7,0.009,823,POINT (-87.629029 41.878153),60604-20210115
60604,01/16/2021,2,44,2,37,0.045,0,7,0.009,823,POINT (-87.629029 41.878153),60604-20210116
60604,01/17/2021,3,47,3,40,0.049,0,7,0.009,823,POINT (-87.629029 41.878153),60604-20210117
60604,01/18/2021,0,47,0,40,0.049,0,7,0.009,823,POINT (-87.629029 41.878153),60604-20210118
60604,01/19/2021,9,56,7,47,0.057,2,9,0.011,823,POINT (-87.629029 41.878153),60604-20210119
60604,01/20/2021,3,59,3,50,0.061,0,9,0.011,823,POINT (-87.629029 41.878153),60604-20210120
60604,01/21/2021,9,68,7,57,0.069,2,11,0.013,823,POINT (-87.629029 41.878153),60604-20210121
60604,01/22/2021,8,76,8,65,0.079,0,11,0.013,823,POINT (-87.629029 41.878153),60604-20210122
60604,01/23/2021,5,81,5,70,0.085,0,11,0.013,823,POINT (-87.629029 41.878153),60604-20210123
60604,01/24/2021,2,83,2,72,0.087,0,11,0.013,823,POINT (-87.629029 41.878153),60604-20210124
60604,01/25/2021,20,103,20,92,0.112,0,11,0.013,823,POINT (-87.629029 41.878153),60604-20210125
60604,01/26/2021,19,122,18,110,0.134,1,12,0.015,823,POINT (-87.629029 41.878153),60604-20210126
60604,01/27/2021,15,137,14,124,0.151,1,13,0.016,823,POINT (-87.629029 41.878153),60604-20210127
60604,01/28/2021,20,157,19,143,0.174,1,14,0.017,823,POINT (-87.629029 41.878153),60604-20210128
60606,01/25/2021,22,399,16,271,0.082,6,128,0.039,3287,POINT (-87.63676 41.882634),60606-20210125
60606,01/26/2021,20,419,18,289,0.088,2,130,0.04,3287,POINT (-87.63676 41.882634),60606-20210126
60606,01/27/2021,15,434,12,301,0.092,3,133,0.04,3287,POINT (-87.63676 41.882634),60606-20210127
60606,01/28/2021,21,455,19,320,0.097,2,135,0.041,3287,POINT (-87.63676 41.882634),60606-20210128
60606,01/30/2021,12,493,8,350,0.106,4,143,0.044,3287,POINT (-87.63676 41.882634),60606-20210130
60606,01/31/2021,2,495,1,351,0.107,1,144,0.044,3287,POINT (-87.63676 41.882634),60606-20210131
60606,02/01/2021,16,511,11,362,0.11,5,149,0.045,3287,POINT (-87.63676 41.882634),60606-20210201
60606,02/02/2021,14,525,11,373,0.113,3,152,0.046,3287,POINT (-87.63676 41.882634),60606-20210202
60606,02/03/2021,11,536,11,384,0.117,0,152,0.046,3287,POINT (-87.63676 41.882634),60606-20210203
60606,02/04/2021,29,565,24,408,0.124,5,157,0.048,3287,POINT (-87.63676 41.882634),60606-20210204
60606,02/05/2021,30,595,23,431,0.131,7,164,0.05,3287,POINT (-87.63676 41.882634),60606-20210205
60606,02/06/2021,7,602,4,435,0.132,3,167,0.051,3287,POINT (-87.63676 41.882634),60606-20210206
60606,02/07/2021,6,608,6,441,0.134,0,167,0.051,3287,POINT (-87.63676 41.882634),60606-20210207
60606,02/08/2021,9,617,8,449,0.137,1,168,0.051,3287,POINT (-87.63676 41.882634),60606-20210208
60606,02/09/2021,23,640,15,464,0.141,8,176,0.054,3287,POINT (-87.63676 41.882634),60606-20210209
60606,02/10/2021,17,657,12,476,0.145,5,181,0.055,3287,POINT (-87.63676 41.882634),60606-20210210
60606,02/11/2021,30,687,12,488,0.148,18,199,0.061,3287,POINT (-87.63676 41.882634),60606-20210211
60606,02/12/2021,34,721,19,507,0.154,15,214,0.065,3287,POINT (-87.63676 41.882634),60606-20210212
60606,02/13/2021,17,738,8,515,0.157,9,223,0.068,3287,POINT (-87.63676 41.882634),60606-20210213
60605,12/26/2020,9,1217,9,1217,0.042,0,0,0,29060,POINT (-87.623449 41.867824),60605-20201226
60605,12/27/2020,2,1219,2,1219,0.042,0,0,0,29060,POINT (-87.623449 41.867824),60605-20201227
60605,12/28/2020,55,1274,55,1274,0.044,0,0,0,29060,POINT (-87.623449 41.867824),60605-20201228
60605,12/29/2020,103,1377,103,1377,0.047,0,0,0,29060,POINT (-87.623449 41.867824),60605-20201229
60605,12/30/2020,130,1507,130,1507,0.052,0,0,0,29060,POINT (-87.623449 41.867824),60605-20201230
60605,12/31/2020,40,1547,40,1547,0.053,0,0,0,29060,POINT (-87.623449 41.867824),60605-20201231
60605,01/01/2021,2,1549,2,1549,0.053,0,0,0,29060,POINT (-87.623449 41.867824),60605-20210101
60605,01/02/2021,18,1567,18,1567,0.054,0,0,0,29060,POINT (-87.623449 41.867824),60605-20210102
60605,01/03/2021,33,1600,29,1596,0.055,4,4,0,29060,POINT (-87.623449 41.867824),60605-20210103
60605,01/04/2021,107,1707,89,1685,0.058,18,22,0.001,29060,POINT (-87.623449 41.867824),60605-20210104
60605,01/05/2021,105,1812,75,1760,0.061,30,52,0.002,29060,POINT (-87.623449 41.867824),60605-20210105
60605,01/06/2021,86,1898,42,1802,0.062,44,96,0.003,29060,POINT (-87.623449 41.867824),60605-20210106
60605,01/07/2021,220,2118,56,1858,0.064,164,260,0.009,29060,POINT (-87.623449 41.867824),60605-20210107
60606,02/14/2021,2,740,0,515,0.157,2,225,0.068,3287,POINT (-87.63676 41.882634),60606-20210214
60606,02/15/2021,13,753,7,522,0.159,6,231,0.07,3287,POINT (-87.63676 41.882634),60606-20210215
60606,02/16/2021,17,770,13,535,0.163,4,235,0.071,3287,POINT (-87.63676 41.882634),60606-20210216
60606,02/17/2021,23,793,10,545,0.166,13,248,0.075,3287,POINT (-87.63676 41.882634),60606-20210217
60606,02/18/2021,27,820,12,557,0.169,15,263,0.08,3287,POINT (-87.63676 41.882634),60606-20210218
60607,01/29/2021,161,5288,112,3585,0.122,49,1703,0.058,29293,POINT (-87.652727 41.876104),60607-20210129
60607,01/30/2021,86,5374,56,3641,0.124,30,1733,0.059,29293,POINT (-87.652727 41.876104),60607-20210130
60607,01/31/2021,21,5395,14,3655,0.125,7,1740,0.059,29293,POINT (-87.652727 41.876104),60607-20210131
60607,02/01/2021,109,5504,75,3730,0.127,34,1774,0.061,29293,POINT (-87.652727 41.876104),60607-20210201
60607,02/02/2021,155,5659,80,3810,0.13,75,1849,0.063,29293,POINT (-87.652727 41.876104),60607-20210202
60607,02/03/2021,248,5907,169,3979,0.136,79,1928,0.066,29293,POINT (-87.652727 41.876104),60607-20210203
60607,02/04/2021,211,6118,147,4126,0.141,64,1992,0.068,29293,POINT (-87.652727 41.876104),60607-20210204
60607,02/05/2021,202,6320,132,4258,0.145,70,2062,0.07,29293,POINT (-87.652727 41.876104),60607-20210205
60607,02/06/2021,111,6431,74,4332,0.148,37,2099,0.072,29293,POINT (-87.652727 41.876104),60607-20210206
60607,02/07/2021,16,6447,7,4339,0.148,9,2108,0.072,29293,POINT (-87.652727 41.876104),60607-20210207
60607,02/08/2021,103,6550,64,4403,0.15,39,2147,0.073,29293,POINT (-87.652727 41.876104),60607-20210208
60607,02/09/2021,128,6678,72,4475,0.153,56,2203,0.075,29293,POINT (-87.652727 41.876104),60607-20210209
60607,02/10/2021,216,6894,111,4586,0.157,105,2308,0.079,29293,POINT (-87.652727 41.876104),60607-20210210
60607,02/11/2021,239,7133,93,4679,0.16,146,2454,0.084,29293,POINT (-87.652727 41.876104),60607-20210211
60607,02/12/2021,231,7364,93,4772,0.163,138,2592,0.088,29293,POINT (-87.652727 41.876104),60607-20210212
60607,02/13/2021,79,7443,42,4814,0.164,37,2629,0.09,29293,POINT (-87.652727 41.876104),60607-20210213
60607,02/14/2021,22,7465,16,4830,0.165,6,2635,0.09,29293,POINT (-87.652727 41.876104),60607-20210214
60607,02/15/2021,98,7563,51,4881,0.167,47,2682,0.092,29293,POINT (-87.652727 41.876104),60607-20210215
60607,02/16/2021,88,7651,57,4938,0.169,31,2713,0.093,29293,POINT (-87.652727 41.876104),60607-20210216
60607,02/17/2021,154,7805,70,5008,0.171,84,2797,0.095,29293,POINT (-87.652727 41.876104),60607-20210217
60607,02/18/2021,160,7965,61,5069,0.173,99,2896,0.099,29293,POINT (-87.652727 41.876104),60607-20210218
60608,01/19/2021,140,2709,76,2078,0.026,64,631,0.008,80059,POINT (-87.670366 41.849879),60608-20210119
60608,01/20/2021,307,3016,219,2297,0.029,88,719,0.009,80059,POINT (-87.670366 41.849879),60608-20210120
60608,01/21/2021,326,3342,261,2558,0.032,65,784,0.01,80059,POINT (-87.670366 41.849879),60608-20210121
60608,01/22/2021,250,3592,238,2796,0.035,12,796,0.01,80059,POINT (-87.670366 41.849879),60608-20210122
60608,01/23/2021,142,3734,135,2931,0.037,7,803,0.01,80059,POINT (-87.670366 41.849879),60608-20210123
60608,01/24/2021,35,3769,33,2964,0.037,2,805,0.01,80059,POINT (-87.670366 41.849879),60608-20210124
60608,01/25/2021,228,3997,159,3123,0.039,69,874,0.011,80059,POINT (-87.670366 41.849879),60608-20210125
60608,01/26/2021,194,4191,141,3264,0.041,53,927,0.012,80059,POINT (-87.670366 41.849879),60608-20210126
60608,01/27/2021,313,4504,261,3525,0.044,52,979,0.012,80059,POINT (-87.670366 41.849879),60608-20210127
60608,01/28/2021,302,4806,248,3773,0.047,54,1033,0.013,80059,POINT (-87.670366 41.849879),60608-20210128
60608,01/29/2021,363,5169,303,4076,0.051,60,1093,0.014,80059,POINT (-87.670366 41.849879),60608-20210129
60608,01/30/2021,229,5398,191,4267,0.053,38,1131,0.014,80059,POINT (-87.670366 41.849879),60608-20210130
60608,01/31/2021,34,5432,30,4297,0.054,4,1135,0.014,80059,POINT (-87.670366 41.849879),60608-20210131
60608,02/01/2021,242,5674,213,4510,0.056,29,1164,0.015,80059,POINT (-87.670366 41.849879),60608-20210201
60608,02/02/2021,331,6005,260,4770,0.06,71,1235,0.015,80059,POINT (-87.670366 41.849879),60608-20210202
60608,02/03/2021,438,6443,367,5137,0.064,71,1306,0.016,80059,POINT (-87.670366 41.849879),60608-20210203
60608,02/04/2021,405,6848,321,5458,0.068,84,1390,0.017,80059,POINT (-87.670366 41.849879),60608-20210204
60608,02/05/2021,402,7250,341,5799,0.072,61,1451,0.018,80059,POINT (-87.670366 41.849879),60608-20210205
60608,02/06/2021,323,7573,212,6011,0.075,111,1562,0.02,80059,POINT (-87.670366 41.849879),60608-20210206
60608,02/07/2021,144,7717,83,6094,0.076,61,1623,0.02,80059,POINT (-87.670366 41.849879),60608-20210207
60608,02/08/2021,257,7974,206,6300,0.079,51,1674,0.021,80059,POINT (-87.670366 41.849879),60608-20210208
60608,02/09/2021,316,8290,250,6550,0.082,66,1740,0.022,80059,POINT (-87.670366 41.849879),60608-20210209
60608,02/10/2021,439,8729,325,6875,0.086,114,1854,0.023,80059,POINT (-87.670366 41.849879),60608-20210210
60608,02/11/2021,478,9207,274,7149,0.089,204,2058,0.026,80059,POINT (-87.670366 41.849879),60608-20210211
60608,02/12/2021,400,9607,226,7375,0.092,174,2232,0.028,80059,POINT (-87.670366 41.849879),60608-20210212
60608,02/13/2021,249,9856,152,7527,0.094,97,2329,0.029,80059,POINT (-87.670366 41.849879),60608-20210213
60608,02/14/2021,32,9888,18,7545,0.094,14,2343,0.029,80059,POINT (-87.670366 41.849879),60608-20210214
60608,02/15/2021,234,10122,197,7742,0.097,37,2380,0.03,80059,POINT (-87.670366 41.849879),60608-20210215
60608,02/16/2021,183,10305,131,7873,0.098,52,2432,0.03,80059,POINT (-87.670366 41.849879),60608-20210216
60608,02/17/2021,445,10750,215,8088,0.101,230,2662,0.033,80059,POINT (-87.670366 41.849879),60608-20210217
60609,01/24/2021,23,1619,21,1329,0.022,2,290,0.005,60939,POINT (-87.653382 41.812017),60609-20210124
60609,01/25/2021,100,1719,81,1410,0.023,19,309,0.005,60939,POINT (-87.653382 41.812017),60609-20210125
60609,01/26/2021,113,1832,82,1492,0.024,31,340,0.006,60939,POINT (-87.653382 41.812017),60609-20210126
60609,01/27/2021,133,1965,111,1603,0.026,22,362,0.006,60939,POINT (-87.653382 41.812017),60609-20210127
60609,01/28/2021,179,2144,154,1757,0.029,25,387,0.006,60939,POINT (-87.653382 41.812017),60609-20210128
60609,01/29/2021,230,2374,207,1964,0.032,23,410,0.007,60939,POINT (-87.653382 41.812017),60609-20210129
60609,01/30/2021,90,2464,75,2039,0.033,15,425,0.007,60939,POINT (-87.653382 41.812017),60609-20210130
60609,01/31/2021,23,2487,21,2060,0.034,2,427,0.007,60939,POINT (-87.653382 41.812017),60609-20210131
60609,02/01/2021,107,2594,91,2151,0.035,16,443,0.007,60939,POINT (-87.653382 41.812017),60609-20210201
60609,02/02/2021,148,2742,113,2264,0.037,35,478,0.008,60939,POINT (-87.653382 41.812017),60609-20210202
60609,02/03/2021,279,3021,166,2430,0.04,113,591,0.01,60939,POINT (-87.653382 41.812017),60609-20210203
60609,02/04/2021,239,3260,204,2634,0.043,35,626,0.01,60939,POINT (-87.653382 41.812017),60609-20210204
60609,02/05/2021,244,3504,213,2847,0.047,31,657,0.011,60939,POINT (-87.653382 41.812017),60609-20210205
60609,02/06/2021,109,3613,81,2928,0.048,28,685,0.011,60939,POINT (-87.653382 41.812017),60609-20210206
60609,02/07/2021,23,3636,21,2949,0.048,2,687,0.011,60939,POINT (-87.653382 41.812017),60609-20210207
60609,02/08/2021,176,3812,149,3098,0.051,27,714,0.012,60939,POINT (-87.653382 41.812017),60609-20210208
60609,02/09/2021,168,3980,143,3241,0.053,25,739,0.012,60939,POINT (-87.653382 41.812017),60609-20210209
60609,02/10/2021,281,4261,233,3474,0.057,48,787,0.013,60939,POINT (-87.653382 41.812017),60609-20210210
60609,02/11/2021,289,4550,199,3673,0.06,90,877,0.014,60939,POINT (-87.653382 41.812017),60609-20210211
60609,02/12/2021,261,4811,187,3860,0.063,74,951,0.016,60939,POINT (-87.653382 41.812017),60609-20210212
60609,02/13/2021,251,5062,138,3998,0.066,113,1064,0.017,60939,POINT (-87.653382 41.812017),60609-20210213
60609,02/14/2021,29,5091,19,4017,0.066,10,1074,0.018,60939,POINT (-87.653382 41.812017),60609-20210214
60609,02/15/2021,180,5271,144,4161,0.068,36,1110,0.018,60939,POINT (-87.653382 41.812017),60609-20210215
60609,02/16/2021,130,5401,95,4256,0.07,35,1145,0.019,60939,POINT (-87.653382 41.812017),60609-20210216
60609,02/17/2021,200,5601,110,4366,0.072,90,1235,0.02,60939,POINT (-87.653382 41.812017),60609-20210217
60610,01/20/2021,178,2737,130,1924,0.047,48,813,0.02,40548,POINT (-87.63581 41.90455),60610-20210120
60610,01/21/2021,296,3033,272,2196,0.054,24,837,0.021,40548,POINT (-87.63581 41.90455),60610-20210121
60610,01/22/2021,344,3377,324,2520,0.062,20,857,0.021,40548,POINT (-87.63581 41.90455),60610-20210122
60610,01/23/2021,110,3487,99,2619,0.065,11,868,0.021,40548,POINT (-87.63581 41.90455),60610-20210123
60610,01/24/2021,41,3528,35,2654,0.065,6,874,0.022,40548,POINT (-87.63581 41.90455),60610-20210124
60610,01/25/2021,151,3679,112,2766,0.068,39,913,0.023,40548,POINT (-87.63581 41.90455),60610-20210125
60610,01/26/2021,217,3896,121,2887,0.071,96,1009,0.025,40548,POINT (-87.63581 41.90455),60610-20210126
60610,01/27/2021,179,4075,133,3020,0.074,46,1055,0.026,40548,POINT (-87.63581 41.90455),60610-20210127
60610,01/28/2021,284,4359,245,3265,0.081,39,1094,0.027,40548,POINT (-87.63581 41.90455),60610-20210128
60610,01/29/2021,286,4645,268,3533,0.087,18,1112,0.027,40548,POINT (-87.63581 41.90455),60610-20210129
60610,01/30/2021,101,4746,75,3608,0.089,26,1138,0.028,40548,POINT (-87.63581 41.90455),60610-20210130
60610,01/31/2021,32,4778,30,3638,0.09,2,1140,0.028,40548,POINT (-87.63581 41.90455),60610-20210131
60610,02/01/2021,131,4909,100,3738,0.092,31,1171,0.029,40548,POINT (-87.63581 41.90455),60610-20210201
60610,02/02/2021,226,5135,153,3891,0.096,73,1244,0.031,40548,POINT (-87.63581 41.90455),60610-20210202
60610,02/03/2021,154,5289,115,4006,0.099,39,1283,0.032,40548,POINT (-87.63581 41.90455),60610-20210203
60610,02/04/2021,306,5595,259,4265,0.105,47,1330,0.033,40548,POINT (-87.63581 41.90455),60610-20210204
60610,02/05/2021,505,6100,400,4665,0.115,105,1435,0.035,40548,POINT (-87.63581 41.90455),60610-20210205
60610,02/07/2021,37,6248,29,4770,0.118,8,1478,0.036,40548,POINT (-87.63581 41.90455),60610-20210207
60610,02/08/2021,143,6391,89,4859,0.12,54,1532,0.038,40548,POINT (-87.63581 41.90455),60610-20210208
60610,02/09/2021,165,6556,122,4981,0.123,43,1575,0.039,40548,POINT (-87.63581 41.90455),60610-20210209
60610,02/10/2021,300,6856,227,5208,0.128,73,1648,0.041,40548,POINT (-87.63581 41.90455),60610-20210210
60610,02/11/2021,339,7195,101,5309,0.131,238,1886,0.047,40548,POINT (-87.63581 41.90455),60610-20210211
60610,02/12/2021,372,7567,101,5410,0.133,271,2157,0.053,40548,POINT (-87.63581 41.90455),60610-20210212
60610,02/13/2021,156,7723,86,5496,0.136,70,2227,0.055,40548,POINT (-87.63581 41.90455),60610-20210213
60610,02/14/2021,43,7766,34,5530,0.136,9,2236,0.055,40548,POINT (-87.63581 41.90455),60610-20210214
60610,02/15/2021,94,7860,52,5582,0.138,42,2278,0.056,40548,POINT (-87.63581 41.90455),60610-20210215
60610,02/16/2021,223,8083,182,5764,0.142,41,2319,0.057,40548,POINT (-87.63581 41.90455),60610-20210216
60610,02/17/2021,228,8311,79,5843,0.144,149,2468,0.061,40548,POINT (-87.63581 41.90455),60610-20210217
60610,02/18/2021,316,8627,114,5957,0.147,202,2670,0.066,40548,POINT (-87.63581 41.90455),60610-20210218
60611,01/07/2021,227,2640,42,2399,0.072,185,241,0.007,33224,POINT (-87.620291 41.894734),60611-20210107
60611,01/08/2021,961,3601,440,2839,0.085,521,762,0.023,33224,POINT (-87.620291 41.894734),60611-20210108
60611,01/09/2021,213,3814,51,2890,0.087,162,924,0.028,33224,POINT (-87.620291 41.894734),60611-20210109
60611,01/10/2021,48,3862,12,2902,0.087,36,960,0.029,33224,POINT (-87.620291 41.894734),60611-20210110
60611,01/11/2021,442,4304,79,2981,0.09,363,1323,0.04,33224,POINT (-87.620291 41.894734),60611-20210111
60611,01/12/2021,262,4566,87,3068,0.092,175,1498,0.045,33224,POINT (-87.620291 41.894734),60611-20210112
60611,01/13/2021,151,4717,70,3138,0.094,81,1579,0.048,33224,POINT (-87.620291 41.894734),60611-20210113
60611,01/14/2021,103,4820,66,3204,0.096,37,1616,0.049,33224,POINT (-87.620291 41.894734),60611-20210114
60611,01/15/2021,85,4905,71,3275,0.099,14,1630,0.049,33224,POINT (-87.620291 41.894734),60611-20210115
60611,01/16/2021,60,4965,52,3327,0.1,8,1638,0.049,33224,POINT (-87.620291 41.894734),60611-20210116
60611,01/17/2021,43,5008,11,3338,0.1,32,1670,0.05,33224,POINT (-87.620291 41.894734),60611-20210117
60611,01/18/2021,226,5234,67,3405,0.102,159,1829,0.055,33224,POINT (-87.620291 41.894734),60611-20210118
60611,01/19/2021,161,5395,63,3468,0.104,98,1927,0.058,33224,POINT (-87.620291 41.894734),60611-20210119
60611,01/20/2021,166,5561,113,3581,0.108,53,1980,0.06,33224,POINT (-87.620291 41.894734),60611-20210120
60611,01/21/2021,444,6005,419,4000,0.12,25,2005,0.06,33224,POINT (-87.620291 41.894734),60611-20210121
60611,01/22/2021,492,6497,466,4466,0.134,26,2031,0.061,33224,POINT (-87.620291 41.894734),60611-20210122
60611,01/23/2021,136,6633,130,4596,0.138,6,2037,0.061,33224,POINT (-87.620291 41.894734),60611-20210123
60611,01/24/2021,55,6688,51,4647,0.14,4,2041,0.061,33224,POINT (-87.620291 41.894734),60611-20210124
60611,01/25/2021,166,6854,130,4777,0.144,36,2077,0.063,33224,POINT (-87.620291 41.894734),60611-20210125
60611,01/26/2021,453,7307,122,4899,0.147,331,2408,0.072,33224,POINT (-87.620291 41.894734),60611-20210126
60611,01/27/2021,212,7519,148,5047,0.152,64,2472,0.074,33224,POINT (-87.620291 41.894734),60611-20210127
60611,01/28/2021,399,7918,296,5343,0.161,103,2575,0.078,33224,POINT (-87.620291 41.894734),60611-20210128
60611,01/29/2021,365,8283,335,5678,0.171,30,2605,0.078,33224,POINT (-87.620291 41.894734),60611-20210129
60611,01/30/2021,93,8376,71,5749,0.173,22,2627,0.079,33224,POINT (-87.620291 41.894734),60611-20210130
60611,01/31/2021,39,8415,27,5776,0.174,12,2639,0.079,33224,POINT (-87.620291 41.894734),60611-20210131
60611,02/01/2021,104,8519,78,5854,0.176,26,2665,0.08,33224,POINT (-87.620291 41.894734),60611-20210201
60611,02/02/2021,273,8792,126,5980,0.18,147,2812,0.085,33224,POINT (-87.620291 41.894734),60611-20210202
60611,02/03/2021,170,8962,129,6109,0.184,41,2853,0.086,33224,POINT (-87.620291 41.894734),60611-20210203
60611,02/04/2021,342,9304,309,6418,0.193,33,2886,0.087,33224,POINT (-87.620291 41.894734),60611-20210204
60611,02/05/2021,680,9984,384,6802,0.205,296,3182,0.096,33224,POINT (-87.620291 41.894734),60611-20210205
60611,02/06/2021,104,10088,67,6869,0.207,37,3219,0.097,33224,POINT (-87.620291 41.894734),60611-20210206
60611,02/07/2021,39,10127,33,6902,0.208,6,3225,0.097,33224,POINT (-87.620291 41.894734),60611-20210207
60611,02/08/2021,224,10351,89,6991,0.21,135,3360,0.101,33224,POINT (-87.620291 41.894734),60611-20210208
60611,02/09/2021,172,10523,118,7109,0.214,54,3414,0.103,33224,POINT (-87.620291 41.894734),60611-20210209
60611,02/10/2021,346,10869,290,7399,0.223,56,3470,0.104,33224,POINT (-87.620291 41.894734),60611-20210210
60611,02/11/2021,462,11331,108,7507,0.226,354,3824,0.115,33224,POINT (-87.620291 41.894734),60611-20210211
60611,02/12/2021,497,11828,122,7629,0.23,375,4199,0.126,33224,POINT (-87.620291 41.894734),60611-20210212
60611,02/13/2021,145,11973,61,7690,0.231,84,4283,0.129,33224,POINT (-87.620291 41.894734),60611-20210213
60611,02/14/2021,42,12015,32,7722,0.232,10,4293,0.129,33224,POINT (-87.620291 41.894734),60611-20210214
60611,02/15/2021,111,12126,55,7777,0.234,56,4349,0.131,33224,POINT (-87.620291 41.894734),60611-20210215
60611,02/16/2021,275,12401,232,8009,0.241,43,4392,0.132,33224,POINT (-87.620291 41.894734),60611-20210216
60611,02/17/2021,220,12621,70,8079,0.243,150,4542,0.137,33224,POINT (-87.620291 41.894734),60611-20210217
60611,02/18/2021,419,13040,126,8205,0.247,293,4835,0.146,33224,POINT (-87.620291 41.894734),60611-20210218
60612,01/29/2021,171,3470,139,2455,0.073,32,1015,0.03,33735,POINT (-87.687011 41.88004),60612-20210129
60612,01/30/2021,58,3528,47,2502,0.074,11,1026,0.03,33735,POINT (-87.687011 41.88004),60612-20210130
60612,01/31/2021,43,3571,37,2539,0.075,6,1032,0.031,33735,POINT (-87.687011 41.88004),60612-20210131
60612,02/01/2021,96,3667,79,2618,0.078,17,1049,0.031,33735,POINT (-87.687011 41.88004),60612-20210201
60612,02/02/2021,167,3834,110,2728,0.081,57,1106,0.033,33735,POINT (-87.687011 41.88004),60612-20210202
60612,02/03/2021,191,4025,120,2848,0.084,71,1177,0.035,33735,POINT (-87.687011 41.88004),60612-20210203
60612,02/04/2021,171,4196,129,2977,0.088,42,1219,0.036,33735,POINT (-87.687011 41.88004),60612-20210204
60612,02/05/2021,196,4392,138,3115,0.092,58,1277,0.038,33735,POINT (-87.687011 41.88004),60612-20210205
60612,02/06/2021,71,4463,46,3161,0.094,25,1302,0.039,33735,POINT (-87.687011 41.88004),60612-20210206
60612,02/07/2021,23,4486,15,3176,0.094,8,1310,0.039,33735,POINT (-87.687011 41.88004),60612-20210207
60612,02/08/2021,99,4585,76,3252,0.096,23,1333,0.04,33735,POINT (-87.687011 41.88004),60612-20210208
60612,02/09/2021,129,4714,92,3344,0.099,37,1370,0.041,33735,POINT (-87.687011 41.88004),60612-20210209
60612,02/10/2021,148,4862,84,3428,0.102,64,1434,0.043,33735,POINT (-87.687011 41.88004),60612-20210210
60612,02/11/2021,236,5098,109,3537,0.105,127,1561,0.046,33735,POINT (-87.687011 41.88004),60612-20210211
60612,02/12/2021,215,5313,123,3660,0.108,92,1653,0.049,33735,POINT (-87.687011 41.88004),60612-20210212
60612,02/13/2021,102,5415,70,3730,0.111,32,1685,0.05,33735,POINT (-87.687011 41.88004),60612-20210213
60612,02/14/2021,9,5424,7,3737,0.111,2,1687,0.05,33735,POINT (-87.687011 41.88004),60612-20210214
60612,02/15/2021,80,5504,61,3798,0.113,19,1706,0.051,33735,POINT (-87.687011 41.88004),60612-20210215
60612,02/16/2021,61,5565,42,3840,0.114,19,1725,0.051,33735,POINT (-87.687011 41.88004),60612-20210216
60612,02/17/2021,213,5778,96,3936,0.117,117,1842,0.055,33735,POINT (-87.687011 41.88004),60612-20210217
60613,01/22/2021,250,4307,224,3212,0.063,26,1095,0.022,50761,POINT (-87.661343 41.953742),60613-20210122
60613,01/23/2021,120,4427,112,3324,0.065,8,1103,0.022,50761,POINT (-87.661343 41.953742),60613-20210123
60613,01/24/2021,47,4474,42,3366,0.066,5,1108,0.022,50761,POINT (-87.661343 41.953742),60613-20210124
60613,01/26/2021,374,5041,239,3754,0.074,135,1287,0.025,50761,POINT (-87.661343 41.953742),60613-20210126
60613,01/27/2021,222,5263,162,3916,0.077,60,1347,0.027,50761,POINT (-87.661343 41.953742),60613-20210127
60613,01/28/2021,268,5531,220,4136,0.081,48,1395,0.027,50761,POINT (-87.661343 41.953742),60613-20210128
60613,01/29/2021,259,5790,227,4363,0.086,32,1427,0.028,50761,POINT (-87.661343 41.953742),60613-20210129
60613,01/30/2021,138,5928,109,4472,0.088,29,1456,0.029,50761,POINT (-87.661343 41.953742),60613-20210130
60613,01/31/2021,64,5992,55,4527,0.089,9,1465,0.029,50761,POINT (-87.661343 41.953742),60613-20210131
60613,02/01/2021,170,6162,114,4641,0.091,56,1521,0.03,50761,POINT (-87.661343 41.953742),60613-20210201
60613,02/02/2021,262,6424,145,4786,0.094,117,1638,0.032,50761,POINT (-87.661343 41.953742),60613-20210202
60613,02/03/2021,207,6631,144,4930,0.097,63,1701,0.034,50761,POINT (-87.661343 41.953742),60613-20210203
60613,02/04/2021,304,6935,227,5157,0.102,77,1778,0.035,50761,POINT (-87.661343 41.953742),60613-20210204
60613,02/05/2021,341,7276,255,5412,0.107,86,1864,0.037,50761,POINT (-87.661343 41.953742),60613-20210205
60613,02/06/2021,159,7435,108,5520,0.109,51,1915,0.038,50761,POINT (-87.661343 41.953742),60613-20210206
60613,02/07/2021,57,7492,46,5566,0.11,11,1926,0.038,50761,POINT (-87.661343 41.953742),60613-20210207
60613,02/08/2021,275,7767,139,5705,0.112,136,2062,0.041,50761,POINT (-87.661343 41.953742),60613-20210208
60613,02/09/2021,352,8119,157,5862,0.115,195,2257,0.044,50761,POINT (-87.661343 41.953742),60613-20210209
60613,02/10/2021,371,8490,263,6125,0.121,108,2365,0.047,50761,POINT (-87.661343 41.953742),60613-20210210
60613,02/11/2021,357,8847,190,6315,0.124,167,2532,0.05,50761,POINT (-87.661343 41.953742),60613-20210211
60613,02/12/2021,379,9226,205,6520,0.128,174,2706,0.053,50761,POINT (-87.661343 41.953742),60613-20210212
60613,02/13/2021,251,9477,166,6686,0.132,85,2791,0.055,50761,POINT (-87.661343 41.953742),60613-20210213
60613,02/14/2021,65,9542,40,6726,0.133,25,2816,0.055,50761,POINT (-87.661343 41.953742),60613-20210214
60613,02/15/2021,137,9679,84,6810,0.134,53,2869,0.057,50761,POINT (-87.661343 41.953742),60613-20210215
60613,02/16/2021,180,9859,123,6933,0.137,57,2926,0.058,50761,POINT (-87.661343 41.953742),60613-20210216
60613,02/17/2021,234,10093,107,7040,0.139,127,3053,0.06,50761,POINT (-87.661343 41.953742),60613-20210217
60613,02/18/2021,260,10353,87,7127,0.14,173,3226,0.064,50761,POINT (-87.661343 41.953742),60613-20210218
60614,01/06/2021,109,2273,82,2225,0.031,27,48,0.001,71954,POINT (-87.652064 41.922605),60614-20210106
60614,01/07/2021,229,2502,45,2270,0.032,184,232,0.003,71954,POINT (-87.652064 41.922605),60614-20210107
60614,01/08/2021,401,2903,92,2362,0.033,309,541,0.008,71954,POINT (-87.652064 41.922605),60614-20210108
60614,01/09/2021,192,3095,52,2414,0.034,140,681,0.009,71954,POINT (-87.652064 41.922605),60614-20210109
60614,01/10/2021,77,3172,35,2449,0.034,42,723,0.01,71954,POINT (-87.652064 41.922605),60614-20210110
60614,01/11/2021,359,3531,132,2581,0.036,227,950,0.013,71954,POINT (-87.652064 41.922605),60614-20210111
60614,01/12/2021,320,3851,146,2727,0.038,174,1124,0.016,71954,POINT (-87.652064 41.922605),60614-20210112
60614,01/13/2021,236,4087,147,2874,0.04,89,1213,0.017,71954,POINT (-87.652064 41.922605),60614-20210113
60614,01/14/2021,130,4217,94,2968,0.041,36,1249,0.017,71954,POINT (-87.652064 41.922605),60614-20210114
60614,01/15/2021,273,4490,252,3220,0.045,21,1270,0.018,71954,POINT (-87.652064 41.922605),60614-20210115
60614,01/16/2021,102,4592,80,3300,0.046,22,1292,0.018,71954,POINT (-87.652064 41.922605),60614-20210116
60614,01/17/2021,55,4647,31,3331,0.046,24,1316,0.018,71954,POINT (-87.652064 41.922605),60614-20210117
60614,01/18/2021,301,4948,228,3559,0.049,73,1389,0.019,71954,POINT (-87.652064 41.922605),60614-20210118
60614,01/19/2021,293,5241,187,3746,0.052,106,1495,0.021,71954,POINT (-87.652064 41.922605),60614-20210119
60614,01/20/2021,253,5494,167,3913,0.054,86,1581,0.022,71954,POINT (-87.652064 41.922605),60614-20210120
60614,01/21/2021,368,5862,310,4223,0.059,58,1639,0.023,71954,POINT (-87.652064 41.922605),60614-20210121
60614,01/22/2021,433,6295,393,4616,0.064,40,1679,0.023,71954,POINT (-87.652064 41.922605),60614-20210122
60614,01/23/2021,163,6458,144,4760,0.066,19,1698,0.024,71954,POINT (-87.652064 41.922605),60614-20210123
60614,01/24/2021,71,6529,65,4825,0.067,6,1704,0.024,71954,POINT (-87.652064 41.922605),60614-20210124
60614,01/25/2021,340,6869,269,5094,0.071,71,1775,0.025,71954,POINT (-87.652064 41.922605),60614-20210125
60614,01/26/2021,413,7282,225,5319,0.074,188,1963,0.027,71954,POINT (-87.652064 41.922605),60614-20210126
60614,01/27/2021,307,7589,245,5564,0.077,62,2025,0.028,71954,POINT (-87.652064 41.922605),60614-20210127
60614,01/28/2021,399,7988,341,5905,0.082,58,2083,0.029,71954,POINT (-87.652064 41.922605),60614-20210128
60614,01/29/2021,420,8408,382,6287,0.087,38,2121,0.029,71954,POINT (-87.652064 41.922605),60614-20210129
60614,01/30/2021,169,8577,130,6417,0.089,39,2160,0.03,71954,POINT (-87.652064 41.922605),60614-20210130
60614,01/31/2021,78,8655,63,6480,0.09,15,2175,0.03,71954,POINT (-87.652064 41.922605),60614-20210131
60614,02/01/2021,204,8859,145,6625,0.092,59,2234,0.031,71954,POINT (-87.652064 41.922605),60614-20210201
60612,01/20/2021,220,2322,131,1622,0.048,89,700,0.021,33735,POINT (-87.687011 41.88004),60612-20210120
60614,02/02/2021,335,9194,205,6830,0.095,130,2364,0.033,71954,POINT (-87.652064 41.922605),60614-20210202
60614,02/04/2021,409,9899,359,7410,0.103,50,2489,0.035,71954,POINT (-87.652064 41.922605),60614-20210204
60614,02/05/2021,451,10350,372,7782,0.108,79,2568,0.036,71954,POINT (-87.652064 41.922605),60614-20210205
60614,02/06/2021,219,10569,150,7932,0.11,69,2637,0.037,71954,POINT (-87.652064 41.922605),60614-20210206
60614,02/07/2021,111,10680,79,8011,0.111,32,2669,0.037,71954,POINT (-87.652064 41.922605),60614-20210207
60614,02/08/2021,300,10980,165,8176,0.114,135,2804,0.039,71954,POINT (-87.652064 41.922605),60614-20210208
60614,02/09/2021,267,11247,154,8330,0.116,113,2917,0.041,71954,POINT (-87.652064 41.922605),60614-20210209
60614,02/10/2021,496,11743,349,8679,0.121,147,3064,0.043,71954,POINT (-87.652064 41.922605),60614-20210210
60614,02/11/2021,447,12190,198,8877,0.123,249,3313,0.046,71954,POINT (-87.652064 41.922605),60614-20210211
60614,02/12/2021,676,12866,281,9158,0.127,395,3708,0.052,71954,POINT (-87.652064 41.922605),60614-20210212
60614,02/14/2021,98,13212,69,9371,0.13,29,3841,0.053,71954,POINT (-87.652064 41.922605),60614-20210214
60614,02/15/2021,282,13494,103,9474,0.132,179,4020,0.056,71954,POINT (-87.652064 41.922605),60614-20210215
60614,02/16/2021,346,13840,205,9679,0.135,141,4161,0.058,71954,POINT (-87.652064 41.922605),60614-20210216
60614,02/17/2021,364,14204,138,9817,0.136,226,4387,0.061,71954,POINT (-87.652064 41.922605),60614-20210217
60614,02/18/2021,428,14632,162,9979,0.139,266,4653,0.065,71954,POINT (-87.652064 41.922605),60614-20210218
60615,01/14/2021,75,2505,56,1906,0.047,19,599,0.015,40590,POINT (-87.602725 41.801993),60615-20210114
60615,01/15/2021,89,2594,58,1964,0.048,31,630,0.016,40590,POINT (-87.602725 41.801993),60615-20210115
60615,01/16/2021,128,2722,33,1997,0.049,95,725,0.018,40590,POINT (-87.602725 41.801993),60615-20210116
60615,01/17/2021,82,2804,14,2011,0.05,68,793,0.02,40590,POINT (-87.602725 41.801993),60615-20210117
60615,01/18/2021,264,3068,198,2209,0.054,66,859,0.021,40590,POINT (-87.602725 41.801993),60615-20210118
60615,01/19/2021,246,3314,181,2390,0.059,65,924,0.023,40590,POINT (-87.602725 41.801993),60615-20210119
60615,01/20/2021,281,3595,162,2552,0.063,119,1043,0.026,40590,POINT (-87.602725 41.801993),60615-20210120
60615,01/21/2021,438,4033,337,2889,0.071,101,1144,0.028,40590,POINT (-87.602725 41.801993),60615-20210121
60615,01/22/2021,338,4371,258,3147,0.078,80,1224,0.03,40590,POINT (-87.602725 41.801993),60615-20210122
60615,01/23/2021,208,4579,122,3269,0.081,86,1310,0.032,40590,POINT (-87.602725 41.801993),60615-20210123
60615,01/24/2021,77,4656,75,3344,0.082,2,1312,0.032,40590,POINT (-87.602725 41.801993),60615-20210124
60615,01/25/2021,191,4847,110,3454,0.085,81,1393,0.034,40590,POINT (-87.602725 41.801993),60615-20210125
60613,12/20/2020,17,404,17,404,0.008,0,0,0,50761,POINT (-87.661343 41.953742),60613-20201220
60613,12/21/2020,157,561,157,561,0.011,0,0,0,50761,POINT (-87.661343 41.953742),60613-20201221
60613,12/22/2020,119,680,119,680,0.013,0,0,0,50761,POINT (-87.661343 41.953742),60613-20201222
60613,12/23/2020,87,767,87,767,0.015,0,0,0,50761,POINT (-87.661343 41.953742),60613-20201223
60613,12/24/2020,37,804,37,804,0.016,0,0,0,50761,POINT (-87.661343 41.953742),60613-20201224
60613,12/25/2020,0,804,0,804,0.016,0,0,0,50761,POINT (-87.661343 41.953742),60613-20201225
60613,12/26/2020,19,823,19,823,0.016,0,0,0,50761,POINT (-87.661343 41.953742),60613-20201226
60613,12/27/2020,0,823,0,823,0.016,0,0,0,50761,POINT (-87.661343 41.953742),60613-20201227
60613,12/28/2020,79,902,79,902,0.018,0,0,0,50761,POINT (-87.661343 41.953742),60613-20201228
60613,12/29/2020,142,1044,142,1044,0.021,0,0,0,50761,POINT (-87.661343 41.953742),60613-20201229
60613,12/30/2020,128,1172,128,1172,0.023,0,0,0,50761,POINT (-87.661343 41.953742),60613-20201230
60613,12/31/2020,34,1206,34,1206,0.024,0,0,0,50761,POINT (-87.661343 41.953742),60613-20201231
60613,01/01/2021,0,1206,0,1206,0.024,0,0,0,50761,POINT (-87.661343 41.953742),60613-20210101
60613,01/02/2021,31,1237,31,1237,0.024,0,0,0,50761,POINT (-87.661343 41.953742),60613-20210102
60613,01/03/2021,21,1258,21,1258,0.025,0,0,0,50761,POINT (-87.661343 41.953742),60613-20210103
60613,01/04/2021,89,1347,80,1338,0.026,9,9,0,50761,POINT (-87.661343 41.953742),60613-20210104
60613,01/05/2021,141,1488,134,1472,0.029,7,16,0,50761,POINT (-87.661343 41.953742),60613-20210105
60613,01/06/2021,82,1570,61,1533,0.03,21,37,0.001,50761,POINT (-87.661343 41.953742),60613-20210106
60613,01/07/2021,152,1722,71,1604,0.032,81,118,0.002,50761,POINT (-87.661343 41.953742),60613-20210107
60613,01/08/2021,265,1987,75,1679,0.033,190,308,0.006,50761,POINT (-87.661343 41.953742),60613-20210108
60613,01/09/2021,139,2126,46,1725,0.034,93,401,0.008,50761,POINT (-87.661343 41.953742),60613-20210109
60613,01/10/2021,34,2160,14,1739,0.034,20,421,0.008,50761,POINT (-87.661343 41.953742),60613-20210110
60613,01/11/2021,278,2438,143,1882,0.037,135,556,0.011,50761,POINT (-87.661343 41.953742),60613-20210111
60615,01/26/2021,156,5003,110,3564,0.088,46,1439,0.035,40590,POINT (-87.602725 41.801993),60615-20210126
60615,01/27/2021,202,5205,162,3726,0.092,40,1479,0.036,40590,POINT (-87.602725 41.801993),60615-20210127
60615,01/28/2021,224,5429,172,3898,0.096,52,1531,0.038,40590,POINT (-87.602725 41.801993),60615-20210128
60615,01/29/2021,267,5696,220,4118,0.101,47,1578,0.039,40590,POINT (-87.602725 41.801993),60615-20210129
60615,01/30/2021,113,5809,87,4205,0.104,26,1604,0.04,40590,POINT (-87.602725 41.801993),60615-20210130
60615,01/31/2021,99,5908,98,4303,0.106,1,1605,0.04,40590,POINT (-87.602725 41.801993),60615-20210131
60615,02/01/2021,113,6021,77,4380,0.108,36,1641,0.04,40590,POINT (-87.602725 41.801993),60615-20210201
60615,02/02/2021,148,6169,92,4472,0.11,56,1697,0.042,40590,POINT (-87.602725 41.801993),60615-20210202
60614,01/04/2021,101,1985,89,1973,0.027,12,12,0,71954,POINT (-87.652064 41.922605),60614-20210104
60614,01/05/2021,179,2164,170,2143,0.03,9,21,0,71954,POINT (-87.652064 41.922605),60614-20210105
60615,02/03/2021,152,6321,118,4590,0.113,34,1731,0.043,40590,POINT (-87.602725 41.801993),60615-20210203
60615,02/04/2021,255,6576,164,4754,0.117,91,1822,0.045,40590,POINT (-87.602725 41.801993),60615-20210204
60615,02/05/2021,231,6807,118,4872,0.12,113,1935,0.048,40590,POINT (-87.602725 41.801993),60615-20210205
60615,02/06/2021,147,6954,65,4937,0.122,82,2017,0.05,40590,POINT (-87.602725 41.801993),60615-20210206
60615,02/07/2021,109,7063,109,5046,0.124,0,2017,0.05,40590,POINT (-87.602725 41.801993),60615-20210207
60615,02/08/2021,227,7290,85,5131,0.126,142,2159,0.053,40590,POINT (-87.602725 41.801993),60615-20210208
60615,02/09/2021,216,7506,96,5227,0.129,120,2279,0.056,40590,POINT (-87.602725 41.801993),60615-20210209
60615,02/10/2021,263,7769,123,5350,0.132,140,2419,0.06,40590,POINT (-87.602725 41.801993),60615-20210210
60615,02/11/2021,423,8192,111,5461,0.135,312,2731,0.067,40590,POINT (-87.602725 41.801993),60615-20210211
60615,02/12/2021,354,8546,105,5566,0.137,249,2980,0.073,40590,POINT (-87.602725 41.801993),60615-20210212
60615,02/13/2021,184,8730,79,5645,0.139,105,3085,0.076,40590,POINT (-87.602725 41.801993),60615-20210213
60615,02/14/2021,20,8750,16,5661,0.139,4,3089,0.076,40590,POINT (-87.602725 41.801993),60615-20210214
60615,02/15/2021,127,8877,53,5714,0.141,74,3163,0.078,40590,POINT (-87.602725 41.801993),60615-20210215
60615,02/16/2021,109,8986,44,5758,0.142,65,3228,0.08,40590,POINT (-87.602725 41.801993),60615-20210216
60615,02/17/2021,174,9160,55,5813,0.143,119,3347,0.082,40590,POINT (-87.602725 41.801993),60615-20210217
60615,02/18/2021,246,9406,92,5905,0.145,154,3501,0.086,40590,POINT (-87.602725 41.801993),60615-20210218
60616,01/22/2021,223,3255,197,2381,0.044,26,874,0.016,54197,POINT (-87.629531 41.844869),60616-20210122
60616,01/23/2021,115,3370,104,2485,0.046,11,885,0.016,54197,POINT (-87.629531 41.844869),60616-20210123
60616,01/24/2021,22,3392,20,2505,0.046,2,887,0.016,54197,POINT (-87.629531 41.844869),60616-20210124
60616,01/25/2021,127,3519,87,2592,0.048,40,927,0.017,54197,POINT (-87.629531 41.844869),60616-20210125
60616,01/26/2021,196,3715,132,2724,0.05,64,991,0.018,54197,POINT (-87.629531 41.844869),60616-20210126
60616,01/27/2021,239,3954,209,2933,0.054,30,1021,0.019,54197,POINT (-87.629531 41.844869),60616-20210127
60616,01/28/2021,331,4285,280,3213,0.059,51,1072,0.02,54197,POINT (-87.629531 41.844869),60616-20210128
60616,01/29/2021,255,4540,233,3446,0.064,22,1094,0.02,54197,POINT (-87.629531 41.844869),60616-20210129
60616,01/30/2021,166,4706,143,3589,0.066,23,1117,0.021,54197,POINT (-87.629531 41.844869),60616-20210130
60614,01/01/2021,1,1796,1,1796,0.025,0,0,0,71954,POINT (-87.652064 41.922605),60614-20210101
60614,01/02/2021,53,1849,53,1849,0.026,0,0,0,71954,POINT (-87.652064 41.922605),60614-20210102
60614,01/03/2021,35,1884,35,1884,0.026,0,0,0,71954,POINT (-87.652064 41.922605),60614-20210103
60616,01/31/2021,27,4733,24,3613,0.067,3,1120,0.021,54197,POINT (-87.629531 41.844869),60616-20210131
60616,02/01/2021,133,4866,94,3707,0.068,39,1159,0.021,54197,POINT (-87.629531 41.844869),60616-20210201
60616,02/02/2021,311,5177,202,3909,0.072,109,1268,0.023,54197,POINT (-87.629531 41.844869),60616-20210202
60616,02/03/2021,261,5438,214,4123,0.076,47,1315,0.024,54197,POINT (-87.629531 41.844869),60616-20210203
60616,02/04/2021,416,5854,337,4460,0.082,79,1394,0.026,54197,POINT (-87.629531 41.844869),60616-20210204
60616,02/05/2021,402,6256,339,4799,0.089,63,1457,0.027,54197,POINT (-87.629531 41.844869),60616-20210205
60616,02/06/2021,153,6409,115,4914,0.091,38,1495,0.028,54197,POINT (-87.629531 41.844869),60616-20210206
60616,02/08/2021,281,6742,194,5145,0.095,87,1597,0.029,54197,POINT (-87.629531 41.844869),60616-20210208
60616,02/09/2021,251,6993,187,5332,0.098,64,1661,0.031,54197,POINT (-87.629531 41.844869),60616-20210209
60616,02/10/2021,342,7335,221,5553,0.102,121,1782,0.033,54197,POINT (-87.629531 41.844869),60616-20210210
60616,02/11/2021,263,7598,143,5696,0.105,120,1902,0.035,54197,POINT (-87.629531 41.844869),60616-20210211
60616,02/12/2021,266,7864,137,5833,0.108,129,2031,0.037,54197,POINT (-87.629531 41.844869),60616-20210212
60616,02/13/2021,212,8076,110,5943,0.11,102,2133,0.039,54197,POINT (-87.629531 41.844869),60616-20210213
60616,02/14/2021,57,8133,42,5985,0.11,15,2148,0.04,54197,POINT (-87.629531 41.844869),60616-20210214
60616,02/15/2021,127,8260,85,6070,0.112,42,2190,0.04,54197,POINT (-87.629531 41.844869),60616-20210215
60616,02/16/2021,133,8393,89,6159,0.114,44,2234,0.041,54197,POINT (-87.629531 41.844869),60616-20210216
60616,02/17/2021,296,8689,141,6300,0.116,155,2389,0.044,54197,POINT (-87.629531 41.844869),60616-20210217
60617,01/20/2021,147,1460,114,1183,0.014,33,277,0.003,83553,POINT (-87.556897 41.721257),60617-20210120
60617,01/21/2021,273,1733,249,1432,0.017,24,301,0.004,83553,POINT (-87.556897 41.721257),60617-20210121
60617,01/22/2021,233,1966,212,1644,0.02,21,322,0.004,83553,POINT (-87.556897 41.721257),60617-20210122
60617,01/23/2021,119,2085,118,1762,0.021,1,323,0.004,83553,POINT (-87.556897 41.721257),60617-20210123
60617,01/24/2021,43,2128,43,1805,0.022,0,323,0.004,83553,POINT (-87.556897 41.721257),60617-20210124
60617,01/25/2021,131,2259,102,1907,0.023,29,352,0.004,83553,POINT (-87.556897 41.721257),60617-20210125
60617,01/26/2021,193,2452,145,2052,0.025,48,400,0.005,83553,POINT (-87.556897 41.721257),60617-20210126
60617,01/27/2021,287,2739,258,2310,0.028,29,429,0.005,83553,POINT (-87.556897 41.721257),60617-20210127
60617,01/28/2021,302,3041,280,2590,0.031,22,451,0.005,83553,POINT (-87.556897 41.721257),60617-20210128
60617,01/29/2021,376,3417,354,2944,0.035,22,473,0.006,83553,POINT (-87.556897 41.721257),60617-20210129
60617,01/30/2021,151,3568,142,3086,0.037,9,482,0.006,83553,POINT (-87.556897 41.721257),60617-20210130
60617,01/31/2021,26,3594,23,3109,0.037,3,485,0.006,83553,POINT (-87.556897 41.721257),60617-20210131
60617,02/01/2021,119,3713,107,3216,0.038,12,497,0.006,83553,POINT (-87.556897 41.721257),60617-20210201
60617,02/02/2021,208,3921,156,3372,0.04,52,549,0.007,83553,POINT (-87.556897 41.721257),60617-20210202
60617,02/03/2021,265,4186,230,3602,0.043,35,584,0.007,83553,POINT (-87.556897 41.721257),60617-20210203
60617,02/04/2021,328,4514,286,3888,0.047,42,626,0.007,83553,POINT (-87.556897 41.721257),60617-20210204
60617,02/05/2021,344,4858,249,4137,0.05,95,721,0.009,83553,POINT (-87.556897 41.721257),60617-20210205
60617,02/06/2021,192,5050,160,4297,0.051,32,753,0.009,83553,POINT (-87.556897 41.721257),60617-20210206
60617,02/07/2021,50,5100,49,4346,0.052,1,754,0.009,83553,POINT (-87.556897 41.721257),60617-20210207
60617,02/08/2021,249,5349,186,4532,0.054,63,817,0.01,83553,POINT (-87.556897 41.721257),60617-20210208
60617,02/09/2021,226,5575,158,4690,0.056,68,885,0.011,83553,POINT (-87.556897 41.721257),60617-20210209
60617,02/10/2021,360,5935,253,4943,0.059,107,992,0.012,83553,POINT (-87.556897 41.721257),60617-20210210
60617,02/11/2021,520,6455,301,5244,0.063,219,1211,0.014,83553,POINT (-87.556897 41.721257),60617-20210211
60615,12/15/2020,1,1,1,1,0,0,0,0,40590,POINT (-87.602725 41.801993),60615-20201215
60615,12/16/2020,1,2,1,2,0,0,0,0,40590,POINT (-87.602725 41.801993),60615-20201216
60615,12/17/2020,26,28,26,28,0.001,0,0,0,40590,POINT (-87.602725 41.801993),60615-20201217
60615,12/18/2020,95,123,95,123,0.003,0,0,0,40590,POINT (-87.602725 41.801993),60615-20201218
60615,12/19/2020,52,175,52,175,0.004,0,0,0,40590,POINT (-87.602725 41.801993),60615-20201219
60615,12/20/2020,49,224,49,224,0.006,0,0,0,40590,POINT (-87.602725 41.801993),60615-20201220
60615,12/21/2020,45,269,45,269,0.007,0,0,0,40590,POINT (-87.602725 41.801993),60615-20201221
60615,12/22/2020,130,399,130,399,0.01,0,0,0,40590,POINT (-87.602725 41.801993),60615-20201222
60615,12/23/2020,167,566,167,566,0.014,0,0,0,40590,POINT (-87.602725 41.801993),60615-20201223
60615,12/24/2020,60,626,60,626,0.015,0,0,0,40590,POINT (-87.602725 41.801993),60615-20201224
60615,12/25/2020,0,626,0,626,0.015,0,0,0,40590,POINT (-87.602725 41.801993),60615-20201225
60615,12/26/2020,7,633,7,633,0.016,0,0,0,40590,POINT (-87.602725 41.801993),60615-20201226
60615,12/27/2020,0,633,0,633,0.016,0,0,0,40590,POINT (-87.602725 41.801993),60615-20201227
60615,12/28/2020,23,656,23,656,0.016,0,0,0,40590,POINT (-87.602725 41.801993),60615-20201228
60615,12/29/2020,120,776,120,776,0.019,0,0,0,40590,POINT (-87.602725 41.801993),60615-20201229
60615,12/30/2020,229,1005,229,1005,0.025,0,0,0,40590,POINT (-87.602725 41.801993),60615-20201230
60615,12/31/2020,115,1120,115,1120,0.028,0,0,0,40590,POINT (-87.602725 41.801993),60615-20201231
60615,01/01/2021,0,1120,0,1120,0.028,0,0,0,40590,POINT (-87.602725 41.801993),60615-20210101
60615,01/02/2021,3,1123,3,1123,0.028,0,0,0,40590,POINT (-87.602725 41.801993),60615-20210102
60615,01/03/2021,156,1279,150,1273,0.031,6,6,0,40590,POINT (-87.602725 41.801993),60615-20210103
60615,01/04/2021,169,1448,156,1429,0.035,13,19,0,40590,POINT (-87.602725 41.801993),60615-20210104
60615,01/05/2021,58,1506,36,1465,0.036,22,41,0.001,40590,POINT (-87.602725 41.801993),60615-20210105
60615,01/06/2021,100,1606,78,1543,0.038,22,63,0.002,40590,POINT (-87.602725 41.801993),60615-20210106
60615,01/07/2021,115,1721,68,1611,0.04,47,110,0.003,40590,POINT (-87.602725 41.801993),60615-20210107
60615,01/08/2021,156,1877,75,1686,0.042,81,191,0.005,40590,POINT (-87.602725 41.801993),60615-20210108
60615,01/09/2021,106,1983,25,1711,0.042,81,272,0.007,40590,POINT (-87.602725 41.801993),60615-20210109
60615,01/10/2021,86,2069,10,1721,0.042,76,348,0.009,40590,POINT (-87.602725 41.801993),60615-20210110
60615,01/11/2021,104,2173,25,1746,0.043,79,427,0.011,40590,POINT (-87.602725 41.801993),60615-20210111
60615,01/12/2021,128,2301,54,1800,0.044,74,501,0.012,40590,POINT (-87.602725 41.801993),60615-20210112
60615,01/13/2021,129,2430,50,1850,0.046,79,580,0.014,40590,POINT (-87.602725 41.801993),60615-20210113
60617,02/12/2021,453,6908,249,5493,0.066,204,1415,0.017,83553,POINT (-87.556897 41.721257),60617-20210212
60617,02/13/2021,280,7188,187,5680,0.068,93,1508,0.018,83553,POINT (-87.556897 41.721257),60617-20210213
60617,02/14/2021,78,7266,75,5755,0.069,3,1511,0.018,83553,POINT (-87.556897 41.721257),60617-20210214
60617,02/15/2021,205,7471,135,5890,0.07,70,1581,0.019,83553,POINT (-87.556897 41.721257),60617-20210215
60617,02/16/2021,114,7585,47,5937,0.071,67,1648,0.02,83553,POINT (-87.556897 41.721257),60617-20210216
60617,02/17/2021,398,7983,178,6115,0.073,220,1868,0.022,83553,POINT (-87.556897 41.721257),60617-20210217
60618,01/21/2021,323,4715,250,3448,0.036,73,1267,0.013,94907,POINT (-87.703343 41.946699),60618-20210121
60618,01/22/2021,300,5015,269,3717,0.039,31,1298,0.014,94907,POINT (-87.703343 41.946699),60618-20210122
60618,01/23/2021,139,5154,124,3841,0.04,15,1313,0.014,94907,POINT (-87.703343 41.946699),60618-20210123
60618,01/24/2021,53,5207,50,3891,0.041,3,1316,0.014,94907,POINT (-87.703343 41.946699),60618-20210124
60618,01/25/2021,280,5487,217,4108,0.043,63,1379,0.015,94907,POINT (-87.703343 41.946699),60618-20210125
60618,01/26/2021,341,5828,244,4352,0.046,97,1476,0.016,94907,POINT (-87.703343 41.946699),60618-20210126
60618,01/27/2021,355,6183,273,4625,0.049,82,1558,0.016,94907,POINT (-87.703343 41.946699),60618-20210127
60618,01/28/2021,478,6661,405,5030,0.053,73,1631,0.017,94907,POINT (-87.703343 41.946699),60618-20210128
60618,01/29/2021,359,7020,312,5342,0.056,47,1678,0.018,94907,POINT (-87.703343 41.946699),60618-20210129
60618,01/30/2021,205,7225,153,5495,0.058,52,1730,0.018,94907,POINT (-87.703343 41.946699),60618-20210130
60618,01/31/2021,96,7321,79,5574,0.059,17,1747,0.018,94907,POINT (-87.703343 41.946699),60618-20210131
60618,02/01/2021,262,7583,180,5754,0.061,82,1829,0.019,94907,POINT (-87.703343 41.946699),60618-20210201
60618,02/02/2021,404,7987,264,6018,0.063,140,1969,0.021,94907,POINT (-87.703343 41.946699),60618-20210202
60618,02/03/2021,423,8410,320,6338,0.067,103,2072,0.022,94907,POINT (-87.703343 41.946699),60618-20210203
60618,02/04/2021,488,8898,394,6732,0.071,94,2166,0.023,94907,POINT (-87.703343 41.946699),60618-20210204
60618,02/05/2021,479,9377,376,7108,0.075,103,2269,0.024,94907,POINT (-87.703343 41.946699),60618-20210205
60618,02/06/2021,358,9735,263,7371,0.078,95,2364,0.025,94907,POINT (-87.703343 41.946699),60618-20210206
60618,02/07/2021,99,9834,87,7458,0.079,12,2376,0.025,94907,POINT (-87.703343 41.946699),60618-20210207
60618,02/08/2021,279,10113,220,7678,0.081,59,2435,0.026,94907,POINT (-87.703343 41.946699),60618-20210208
60618,02/09/2021,350,10463,253,7931,0.084,97,2532,0.027,94907,POINT (-87.703343 41.946699),60618-20210209
60618,02/10/2021,560,11023,411,8342,0.088,149,2681,0.028,94907,POINT (-87.703343 41.946699),60618-20210210
60618,02/11/2021,536,11559,309,8651,0.091,227,2908,0.031,94907,POINT (-87.703343 41.946699),60618-20210211
60618,02/12/2021,488,12047,335,8986,0.095,153,3061,0.032,94907,POINT (-87.703343 41.946699),60618-20210212
60618,02/13/2021,373,12420,282,9268,0.098,91,3152,0.033,94907,POINT (-87.703343 41.946699),60618-20210213
60618,02/14/2021,127,12547,93,9361,0.099,34,3186,0.034,94907,POINT (-87.703343 41.946699),60618-20210214
60618,02/15/2021,253,12800,175,9536,0.1,78,3264,0.034,94907,POINT (-87.703343 41.946699),60618-20210215
60618,02/16/2021,256,13056,173,9709,0.102,83,3347,0.035,94907,POINT (-87.703343 41.946699),60618-20210216
60616,01/04/2021,76,1025,67,1014,0.019,9,11,0,54197,POINT (-87.629531 41.844869),60616-20210104
60616,01/05/2021,154,1179,143,1157,0.021,11,22,0,54197,POINT (-87.629531 41.844869),60616-20210105
60616,01/06/2021,73,1252,44,1201,0.022,29,51,0.001,54197,POINT (-87.629531 41.844869),60616-20210106
60616,01/07/2021,195,1447,108,1309,0.024,87,138,0.003,54197,POINT (-87.629531 41.844869),60616-20210107
60616,01/08/2021,170,1617,39,1348,0.025,131,269,0.005,54197,POINT (-87.629531 41.844869),60616-20210108
60616,01/09/2021,101,1718,30,1378,0.025,71,340,0.006,54197,POINT (-87.629531 41.844869),60616-20210109
60616,01/10/2021,37,1755,9,1387,0.026,28,368,0.007,54197,POINT (-87.629531 41.844869),60616-20210110
60616,01/11/2021,180,1935,98,1485,0.027,82,450,0.008,54197,POINT (-87.629531 41.844869),60616-20210111
60616,01/12/2021,146,2081,55,1540,0.028,91,541,0.01,54197,POINT (-87.629531 41.844869),60616-20210112
60616,01/13/2021,172,2253,120,1660,0.031,52,593,0.011,54197,POINT (-87.629531 41.844869),60616-20210113
60618,02/17/2021,419,13475,203,9912,0.104,216,3563,0.038,94907,POINT (-87.703343 41.946699),60618-20210217
60618,02/18/2021,444,13919,201,10113,0.107,243,3806,0.04,94907,POINT (-87.703343 41.946699),60618-20210218
60619,01/25/2021,146,1902,128,1661,0.027,18,241,0.004,61207,POINT (-87.60569 41.744737),60619-20210125
60619,01/26/2021,164,2066,132,1793,0.029,32,273,0.004,61207,POINT (-87.60569 41.744737),60619-20210126
60619,01/27/2021,193,2259,170,1963,0.032,23,296,0.005,61207,POINT (-87.60569 41.744737),60619-20210127
60619,01/28/2021,217,2476,199,2162,0.035,18,314,0.005,61207,POINT (-87.60569 41.744737),60619-20210128
60619,01/29/2021,296,2772,274,2436,0.04,22,336,0.005,61207,POINT (-87.60569 41.744737),60619-20210129
60619,01/30/2021,109,2881,97,2533,0.041,12,348,0.006,61207,POINT (-87.60569 41.744737),60619-20210130
60619,01/31/2021,15,2896,14,2547,0.042,1,349,0.006,61207,POINT (-87.60569 41.744737),60619-20210131
60619,02/01/2021,142,3038,117,2664,0.044,25,374,0.006,61207,POINT (-87.60569 41.744737),60619-20210201
60619,02/02/2021,153,3191,117,2781,0.045,36,410,0.007,61207,POINT (-87.60569 41.744737),60619-20210202
60619,02/03/2021,223,3414,186,2967,0.048,37,447,0.007,61207,POINT (-87.60569 41.744737),60619-20210203
60619,02/04/2021,238,3652,192,3159,0.052,46,493,0.008,61207,POINT (-87.60569 41.744737),60619-20210204
60619,02/05/2021,241,3893,199,3358,0.055,42,535,0.009,61207,POINT (-87.60569 41.744737),60619-20210205
60619,02/06/2021,130,4023,98,3456,0.056,32,567,0.009,61207,POINT (-87.60569 41.744737),60619-20210206
60619,02/07/2021,49,4072,44,3500,0.057,5,572,0.009,61207,POINT (-87.60569 41.744737),60619-20210207
60619,02/08/2021,211,4283,166,3666,0.06,45,617,0.01,61207,POINT (-87.60569 41.744737),60619-20210208
60619,02/09/2021,235,4518,148,3814,0.062,87,704,0.012,61207,POINT (-87.60569 41.744737),60619-20210209
60619,02/10/2021,338,4856,232,4046,0.066,106,810,0.013,61207,POINT (-87.60569 41.744737),60619-20210210
60619,02/11/2021,445,5301,204,4250,0.069,241,1051,0.017,61207,POINT (-87.60569 41.744737),60619-20210211
60619,02/12/2021,297,5598,145,4395,0.072,152,1203,0.02,61207,POINT (-87.60569 41.744737),60619-20210212
60619,02/13/2021,230,5828,159,4554,0.074,71,1274,0.021,61207,POINT (-87.60569 41.744737),60619-20210213
60619,02/14/2021,46,5874,44,4598,0.075,2,1276,0.021,61207,POINT (-87.60569 41.744737),60619-20210214
60619,02/15/2021,177,6051,99,4697,0.077,78,1354,0.022,61207,POINT (-87.60569 41.744737),60619-20210215
60619,02/16/2021,105,6156,39,4736,0.077,66,1420,0.023,61207,POINT (-87.60569 41.744737),60619-20210216
60619,02/17/2021,219,6375,72,4808,0.079,147,1567,0.026,61207,POINT (-87.60569 41.744737),60619-20210217
60619,02/18/2021,271,6646,100,4908,0.08,171,1738,0.028,61207,POINT (-87.60569 41.744737),60619-20210218
60620,01/23/2021,64,1377,59,1155,0.017,5,222,0.003,67711,POINT (-87.651656 41.740873),60620-20210123
60620,01/24/2021,27,1404,27,1182,0.017,0,222,0.003,67711,POINT (-87.651656 41.740873),60620-20210124
60620,01/25/2021,107,1511,86,1268,0.019,21,243,0.004,67711,POINT (-87.651656 41.740873),60620-20210125
60620,01/26/2021,115,1626,83,1351,0.02,32,275,0.004,67711,POINT (-87.651656 41.740873),60620-20210126
60620,01/27/2021,130,1756,106,1457,0.022,24,299,0.004,67711,POINT (-87.651656 41.740873),60620-20210127
60620,01/28/2021,163,1919,141,1598,0.024,22,321,0.005,67711,POINT (-87.651656 41.740873),60620-20210128
60620,01/29/2021,213,2132,181,1779,0.026,32,353,0.005,67711,POINT (-87.651656 41.740873),60620-20210129
60620,01/30/2021,95,2227,81,1860,0.027,14,367,0.005,67711,POINT (-87.651656 41.740873),60620-20210130
60620,01/31/2021,13,2240,13,1873,0.028,0,367,0.005,67711,POINT (-87.651656 41.740873),60620-20210131
60620,02/01/2021,135,2375,120,1993,0.029,15,382,0.006,67711,POINT (-87.651656 41.740873),60620-20210201
60620,02/02/2021,152,2527,124,2117,0.031,28,410,0.006,67711,POINT (-87.651656 41.740873),60620-20210202
60620,02/03/2021,316,2843,201,2318,0.034,115,525,0.008,67711,POINT (-87.651656 41.740873),60620-20210203
60620,02/04/2021,243,3086,217,2535,0.037,26,551,0.008,67711,POINT (-87.651656 41.740873),60620-20210204
60620,02/05/2021,224,3310,179,2714,0.04,45,596,0.009,67711,POINT (-87.651656 41.740873),60620-20210205
60620,02/06/2021,108,3418,89,2803,0.041,19,615,0.009,67711,POINT (-87.651656 41.740873),60620-20210206
60620,02/07/2021,40,3458,40,2843,0.042,0,615,0.009,67711,POINT (-87.651656 41.740873),60620-20210207
60620,02/08/2021,174,3632,152,2995,0.044,22,637,0.009,67711,POINT (-87.651656 41.740873),60620-20210208
60620,02/09/2021,216,3848,154,3149,0.047,62,699,0.01,67711,POINT (-87.651656 41.740873),60620-20210209
60620,02/10/2021,269,4117,212,3361,0.05,57,756,0.011,67711,POINT (-87.651656 41.740873),60620-20210210
60620,02/11/2021,309,4426,209,3570,0.053,100,856,0.013,67711,POINT (-87.651656 41.740873),60620-20210211
60620,02/12/2021,218,4644,146,3716,0.055,72,928,0.014,67711,POINT (-87.651656 41.740873),60620-20210212
60620,02/13/2021,221,4865,175,3891,0.057,46,974,0.014,67711,POINT (-87.651656 41.740873),60620-20210213
60620,02/14/2021,42,4907,38,3929,0.058,4,978,0.014,67711,POINT (-87.651656 41.740873),60620-20210214
60620,02/15/2021,150,5057,100,4029,0.06,50,1028,0.015,67711,POINT (-87.651656 41.740873),60620-20210215
60620,02/16/2021,71,5128,41,4070,0.06,30,1058,0.016,67711,POINT (-87.651656 41.740873),60620-20210216
60620,02/17/2021,178,5306,92,4162,0.061,86,1144,0.017,67711,POINT (-87.651656 41.740873),60620-20210217
60620,02/18/2021,276,5582,170,4332,0.064,106,1250,0.018,67711,POINT (-87.651656 41.740873),60620-20210218
60621,01/19/2021,23,354,18,315,0.011,5,39,0.001,28018,POINT (-87.638812 41.776931),60621-20210119
60621,01/20/2021,22,376,14,329,0.012,8,47,0.002,28018,POINT (-87.638812 41.776931),60621-20210120
60621,01/21/2021,93,469,93,422,0.015,0,47,0.002,28018,POINT (-87.638812 41.776931),60621-20210121
60621,01/22/2021,39,508,36,458,0.016,3,50,0.002,28018,POINT (-87.638812 41.776931),60621-20210122
60621,01/23/2021,19,527,19,477,0.017,0,50,0.002,28018,POINT (-87.638812 41.776931),60621-20210123
60621,01/24/2021,3,530,3,480,0.017,0,50,0.002,28018,POINT (-87.638812 41.776931),60621-20210124
60621,01/25/2021,106,636,97,577,0.021,9,59,0.002,28018,POINT (-87.638812 41.776931),60621-20210125
60621,01/27/2021,125,796,84,684,0.024,41,112,0.004,28018,POINT (-87.638812 41.776931),60621-20210127
60621,01/28/2021,46,842,39,723,0.026,7,119,0.004,28018,POINT (-87.638812 41.776931),60621-20210128
60621,01/29/2021,149,991,95,818,0.029,54,173,0.006,28018,POINT (-87.638812 41.776931),60621-20210129
60621,01/30/2021,17,1008,15,833,0.03,2,175,0.006,28018,POINT (-87.638812 41.776931),60621-20210130
60621,01/31/2021,0,1008,0,833,0.03,0,175,0.006,28018,POINT (-87.638812 41.776931),60621-20210131
60621,02/01/2021,25,1033,21,854,0.03,4,179,0.006,28018,POINT (-87.638812 41.776931),60621-20210201
60621,02/02/2021,31,1064,21,875,0.031,10,189,0.007,28018,POINT (-87.638812 41.776931),60621-20210202
60621,02/03/2021,48,1112,40,915,0.033,8,197,0.007,28018,POINT (-87.638812 41.776931),60621-20210203
60621,02/04/2021,77,1189,65,980,0.035,12,209,0.007,28018,POINT (-87.638812 41.776931),60621-20210204
60621,02/05/2021,54,1243,49,1029,0.037,5,214,0.008,28018,POINT (-87.638812 41.776931),60621-20210205
60621,02/06/2021,36,1279,34,1063,0.038,2,216,0.008,28018,POINT (-87.638812 41.776931),60621-20210206
60621,02/07/2021,1,1280,1,1064,0.038,0,216,0.008,28018,POINT (-87.638812 41.776931),60621-20210207
60621,02/08/2021,38,1318,34,1098,0.039,4,220,0.008,28018,POINT (-87.638812 41.776931),60621-20210208
60621,02/09/2021,49,1367,36,1134,0.04,13,233,0.008,28018,POINT (-87.638812 41.776931),60621-20210209
60621,02/11/2021,56,1499,35,1225,0.044,21,274,0.01,28018,POINT (-87.638812 41.776931),60621-20210211
60621,02/12/2021,60,1559,34,1259,0.045,26,300,0.011,28018,POINT (-87.638812 41.776931),60621-20210212
60621,02/13/2021,63,1622,41,1300,0.046,22,322,0.011,28018,POINT (-87.638812 41.776931),60621-20210213
60621,02/14/2021,12,1634,11,1311,0.047,1,323,0.012,28018,POINT (-87.638812 41.776931),60621-20210214
60621,02/15/2021,84,1718,44,1355,0.048,40,363,0.013,28018,POINT (-87.638812 41.776931),60621-20210215
60621,02/16/2021,17,1735,9,1364,0.049,8,371,0.013,28018,POINT (-87.638812 41.776931),60621-20210216
60621,02/17/2021,50,1785,26,1390,0.05,24,395,0.014,28018,POINT (-87.638812 41.776931),60621-20210217
60621,02/18/2021,72,1857,38,1428,0.051,34,429,0.015,28018,POINT (-87.638812 41.776931),60621-20210218
60622,01/13/2021,216,4295,99,3057,0.057,117,1238,0.023,53294,POINT (-87.681818 41.902762),60622-20210113
60622,01/17/2021,30,4738,14,3431,0.064,16,1307,0.025,53294,POINT (-87.681818 41.902762),60622-20210117
60622,01/19/2021,161,5024,69,3577,0.067,92,1447,0.027,53294,POINT (-87.681818 41.902762),60622-20210119
60622,01/20/2021,262,5286,151,3728,0.07,111,1558,0.029,53294,POINT (-87.681818 41.902762),60622-20210120
60622,01/21/2021,336,5622,258,3986,0.075,78,1636,0.031,53294,POINT (-87.681818 41.902762),60622-20210121
60622,01/22/2021,229,5851,186,4172,0.078,43,1679,0.032,53294,POINT (-87.681818 41.902762),60622-20210122
60622,01/23/2021,92,5943,87,4259,0.08,5,1684,0.032,53294,POINT (-87.681818 41.902762),60622-20210123
60622,01/24/2021,36,5979,34,4293,0.081,2,1686,0.032,53294,POINT (-87.681818 41.902762),60622-20210124
60622,01/25/2021,161,6140,95,4388,0.082,66,1752,0.033,53294,POINT (-87.681818 41.902762),60622-20210125
60622,01/26/2021,248,6388,132,4520,0.085,116,1868,0.035,53294,POINT (-87.681818 41.902762),60622-20210126
60622,01/27/2021,226,6614,155,4675,0.088,71,1939,0.036,53294,POINT (-87.681818 41.902762),60622-20210127
60622,01/28/2021,293,6907,219,4894,0.092,74,2013,0.038,53294,POINT (-87.681818 41.902762),60622-20210128
60622,01/29/2021,246,7153,178,5072,0.095,68,2081,0.039,53294,POINT (-87.681818 41.902762),60622-20210129
60622,01/30/2021,129,7282,92,5164,0.097,37,2118,0.04,53294,POINT (-87.681818 41.902762),60622-20210130
60622,01/31/2021,44,7326,34,5198,0.098,10,2128,0.04,53294,POINT (-87.681818 41.902762),60622-20210131
60622,02/01/2021,158,7484,124,5322,0.1,34,2162,0.041,53294,POINT (-87.681818 41.902762),60622-20210201
60622,02/02/2021,277,7761,175,5497,0.103,102,2264,0.042,53294,POINT (-87.681818 41.902762),60622-20210202
60622,02/03/2021,273,8034,169,5666,0.106,104,2368,0.044,53294,POINT (-87.681818 41.902762),60622-20210203
60622,02/04/2021,279,8313,225,5891,0.111,54,2422,0.045,53294,POINT (-87.681818 41.902762),60622-20210204
60622,02/05/2021,293,8606,210,6101,0.114,83,2505,0.047,53294,POINT (-87.681818 41.902762),60622-20210205
60622,02/06/2021,199,8805,126,6227,0.117,73,2578,0.048,53294,POINT (-87.681818 41.902762),60622-20210206
60622,02/07/2021,54,8859,37,6264,0.118,17,2595,0.049,53294,POINT (-87.681818 41.902762),60622-20210207
60622,02/08/2021,181,9040,112,6376,0.12,69,2664,0.05,53294,POINT (-87.681818 41.902762),60622-20210208
60622,02/09/2021,247,9287,154,6530,0.123,93,2757,0.052,53294,POINT (-87.681818 41.902762),60622-20210209
60622,02/10/2021,300,9587,182,6712,0.126,118,2875,0.054,53294,POINT (-87.681818 41.902762),60622-20210210
60622,02/11/2021,498,10085,220,6932,0.13,278,3153,0.059,53294,POINT (-87.681818 41.902762),60622-20210211
60622,02/12/2021,378,10463,196,7128,0.134,182,3335,0.063,53294,POINT (-87.681818 41.902762),60622-20210212
60622,02/13/2021,231,10694,176,7304,0.137,55,3390,0.064,53294,POINT (-87.681818 41.902762),60622-20210213
60622,02/14/2021,46,10740,34,7338,0.138,12,3402,0.064,53294,POINT (-87.681818 41.902762),60622-20210214
60622,02/15/2021,148,10888,91,7429,0.139,57,3459,0.065,53294,POINT (-87.681818 41.902762),60622-20210215
60622,02/16/2021,102,10990,59,7488,0.141,43,3502,0.066,53294,POINT (-87.681818 41.902762),60622-20210216
60622,02/17/2021,239,11229,124,7612,0.143,115,3617,0.068,53294,POINT (-87.681818 41.902762),60622-20210217
60622,02/18/2021,286,11515,149,7761,0.146,137,3754,0.07,53294,POINT (-87.681818 41.902762),60622-20210218
60623,01/22/2021,183,1696,178,1455,0.018,5,241,0.003,81283,POINT (-87.717446 41.850321),60623-20210122
60620,01/19/2021,67,1002,51,839,0.012,16,163,0.002,67711,POINT (-87.651656 41.740873),60620-20210119
60620,01/20/2021,83,1085,58,897,0.013,25,188,0.003,67711,POINT (-87.651656 41.740873),60620-20210120
60623,01/23/2021,70,1766,68,1523,0.019,2,243,0.003,81283,POINT (-87.717446 41.850321),60623-20210123
60623,01/24/2021,10,1776,8,1531,0.019,2,245,0.003,81283,POINT (-87.717446 41.850321),60623-20210124
60623,01/25/2021,118,1894,84,1615,0.02,34,279,0.003,81283,POINT (-87.717446 41.850321),60623-20210125
60623,01/26/2021,122,2016,103,1718,0.021,19,298,0.004,81283,POINT (-87.717446 41.850321),60623-20210126
60623,01/27/2021,258,2274,169,1887,0.023,89,387,0.005,81283,POINT (-87.717446 41.850321),60623-20210127
60623,01/28/2021,200,2474,157,2044,0.025,43,430,0.005,81283,POINT (-87.717446 41.850321),60623-20210128
60623,01/29/2021,233,2707,209,2253,0.028,24,454,0.006,81283,POINT (-87.717446 41.850321),60623-20210129
60623,01/30/2021,87,2794,72,2325,0.029,15,469,0.006,81283,POINT (-87.717446 41.850321),60623-20210130
60623,01/31/2021,11,2805,10,2335,0.029,1,470,0.006,81283,POINT (-87.717446 41.850321),60623-20210131
60623,02/01/2021,186,2991,164,2499,0.031,22,492,0.006,81283,POINT (-87.717446 41.850321),60623-20210201
60623,02/02/2021,244,3235,211,2710,0.033,33,525,0.006,81283,POINT (-87.717446 41.850321),60623-20210202
60623,02/03/2021,423,3658,329,3039,0.037,94,619,0.008,81283,POINT (-87.717446 41.850321),60623-20210203
60623,02/04/2021,323,3981,270,3309,0.041,53,672,0.008,81283,POINT (-87.717446 41.850321),60623-20210204
60623,02/05/2021,388,4369,334,3643,0.045,54,726,0.009,81283,POINT (-87.717446 41.850321),60623-20210205
60623,02/06/2021,169,4538,150,3793,0.047,19,745,0.009,81283,POINT (-87.717446 41.850321),60623-20210206
60623,02/07/2021,22,4560,17,3810,0.047,5,750,0.009,81283,POINT (-87.717446 41.850321),60623-20210207
60623,02/08/2021,232,4792,215,4025,0.05,17,767,0.009,81283,POINT (-87.717446 41.850321),60623-20210208
60623,02/09/2021,327,5119,257,4282,0.053,70,837,0.01,81283,POINT (-87.717446 41.850321),60623-20210209
60623,02/10/2021,340,5459,285,4567,0.056,55,892,0.011,81283,POINT (-87.717446 41.850321),60623-20210210
60623,02/11/2021,378,5837,279,4846,0.06,99,991,0.012,81283,POINT (-87.717446 41.850321),60623-20210211
60623,02/12/2021,336,6173,252,5098,0.063,84,1075,0.013,81283,POINT (-87.717446 41.850321),60623-20210212
60623,02/13/2021,233,6406,175,5273,0.065,58,1133,0.014,81283,POINT (-87.717446 41.850321),60623-20210213
60623,02/15/2021,192,6619,162,5448,0.067,30,1171,0.014,81283,POINT (-87.717446 41.850321),60623-20210215
60623,02/16/2021,151,6770,130,5578,0.069,21,1192,0.015,81283,POINT (-87.717446 41.850321),60623-20210216
60623,02/17/2021,277,7047,186,5764,0.071,91,1283,0.016,81283,POINT (-87.717446 41.850321),60623-20210217
60623,02/18/2021,272,7319,182,5946,0.073,90,1373,0.017,81283,POINT (-87.717446 41.850321),60623-20210218
60624,01/14/2021,58,390,57,340,0.01,1,50,0.001,34892,POINT (-87.722735 41.879417),60624-20210114
60624,01/15/2021,28,418,25,365,0.01,3,53,0.002,34892,POINT (-87.722735 41.879417),60624-20210115
60624,01/16/2021,10,428,8,373,0.011,2,55,0.002,34892,POINT (-87.722735 41.879417),60624-20210116
60624,01/17/2021,4,432,4,377,0.011,0,55,0.002,34892,POINT (-87.722735 41.879417),60624-20210117
60624,01/18/2021,5,437,5,382,0.011,0,55,0.002,34892,POINT (-87.722735 41.879417),60624-20210118
60624,01/19/2021,29,466,16,398,0.011,13,68,0.002,34892,POINT (-87.722735 41.879417),60624-20210119
60624,01/20/2021,53,519,40,438,0.013,13,81,0.002,34892,POINT (-87.722735 41.879417),60624-20210120
60624,01/21/2021,56,575,44,482,0.014,12,93,0.003,34892,POINT (-87.722735 41.879417),60624-20210121
60624,01/22/2021,46,621,42,524,0.015,4,97,0.003,34892,POINT (-87.722735 41.879417),60624-20210122
60624,01/23/2021,16,637,16,540,0.015,0,97,0.003,34892,POINT (-87.722735 41.879417),60624-20210123
60624,01/24/2021,3,640,2,542,0.016,1,98,0.003,34892,POINT (-87.722735 41.879417),60624-20210124
60624,01/25/2021,50,690,35,577,0.017,15,113,0.003,34892,POINT (-87.722735 41.879417),60624-20210125
60624,01/26/2021,43,733,29,606,0.017,14,127,0.004,34892,POINT (-87.722735 41.879417),60624-20210126
60624,01/27/2021,78,811,62,668,0.019,16,143,0.004,34892,POINT (-87.722735 41.879417),60624-20210127
60624,01/28/2021,80,891,68,736,0.021,12,155,0.004,34892,POINT (-87.722735 41.879417),60624-20210128
60624,01/29/2021,111,1002,105,841,0.024,6,161,0.005,34892,POINT (-87.722735 41.879417),60624-20210129
60624,01/30/2021,28,1030,22,863,0.025,6,167,0.005,34892,POINT (-87.722735 41.879417),60624-20210130
60624,01/31/2021,6,1036,6,869,0.025,0,167,0.005,34892,POINT (-87.722735 41.879417),60624-20210131
60624,02/01/2021,103,1139,93,962,0.028,10,177,0.005,34892,POINT (-87.722735 41.879417),60624-20210201
60624,02/02/2021,94,1233,70,1032,0.03,24,201,0.006,34892,POINT (-87.722735 41.879417),60624-20210202
60624,02/03/2021,114,1347,97,1129,0.032,17,218,0.006,34892,POINT (-87.722735 41.879417),60624-20210203
60624,02/04/2021,99,1446,83,1212,0.035,16,234,0.007,34892,POINT (-87.722735 41.879417),60624-20210204
60624,02/05/2021,93,1539,78,1290,0.037,15,249,0.007,34892,POINT (-87.722735 41.879417),60624-20210205
60624,02/06/2021,40,1579,31,1321,0.038,9,258,0.007,34892,POINT (-87.722735 41.879417),60624-20210206
60624,02/07/2021,19,1598,18,1339,0.038,1,259,0.007,34892,POINT (-87.722735 41.879417),60624-20210207
60624,02/08/2021,77,1675,74,1413,0.04,3,262,0.008,34892,POINT (-87.722735 41.879417),60624-20210208
60624,02/09/2021,89,1764,68,1481,0.042,21,283,0.008,34892,POINT (-87.722735 41.879417),60624-20210209
60624,02/10/2021,90,1854,77,1558,0.045,13,296,0.008,34892,POINT (-87.722735 41.879417),60624-20210210
60624,02/11/2021,183,2037,115,1673,0.048,68,364,0.01,34892,POINT (-87.722735 41.879417),60624-20210211
60624,02/12/2021,140,2177,108,1781,0.051,32,396,0.011,34892,POINT (-87.722735 41.879417),60624-20210212
60624,02/13/2021,57,2234,38,1819,0.052,19,415,0.012,34892,POINT (-87.722735 41.879417),60624-20210213
60624,02/14/2021,7,2241,5,1824,0.052,2,417,0.012,34892,POINT (-87.722735 41.879417),60624-20210214
60624,02/15/2021,45,2286,43,1867,0.054,2,419,0.012,34892,POINT (-87.722735 41.879417),60624-20210215
60624,02/16/2021,28,2314,21,1888,0.054,7,426,0.012,34892,POINT (-87.722735 41.879417),60624-20210216
60624,02/17/2021,88,2402,50,1938,0.056,38,464,0.013,34892,POINT (-87.722735 41.879417),60624-20210217
60624,02/18/2021,93,2495,55,1993,0.057,38,502,0.014,34892,POINT (-87.722735 41.879417),60624-20210218
60625,01/19/2021,133,3252,83,2536,0.032,50,716,0.009,79444,POINT (-87.701816 41.971155),60625-20210119
60625,01/20/2021,284,3536,201,2737,0.034,83,799,0.01,79444,POINT (-87.701816 41.971155),60625-20210120
60625,01/21/2021,391,3927,303,3040,0.038,88,887,0.011,79444,POINT (-87.701816 41.971155),60625-20210121
60625,01/22/2021,226,4153,208,3248,0.041,18,905,0.011,79444,POINT (-87.701816 41.971155),60625-20210122
60625,01/23/2021,121,4274,110,3358,0.042,11,916,0.012,79444,POINT (-87.701816 41.971155),60625-20210123
60625,01/24/2021,56,4330,49,3407,0.043,7,923,0.012,79444,POINT (-87.701816 41.971155),60625-20210124
60625,01/25/2021,243,4573,160,3567,0.045,83,1006,0.013,79444,POINT (-87.701816 41.971155),60625-20210125
60625,01/26/2021,246,4819,167,3734,0.047,79,1085,0.014,79444,POINT (-87.701816 41.971155),60625-20210126
60625,01/27/2021,357,5176,260,3994,0.05,97,1182,0.015,79444,POINT (-87.701816 41.971155),60625-20210127
60625,01/28/2021,269,5445,218,4212,0.053,51,1233,0.016,79444,POINT (-87.701816 41.971155),60625-20210128
60625,01/29/2021,279,5724,253,4465,0.056,26,1259,0.016,79444,POINT (-87.701816 41.971155),60625-20210129
60625,01/30/2021,231,5955,199,4664,0.059,32,1291,0.016,79444,POINT (-87.701816 41.971155),60625-20210130
60625,01/31/2021,129,6084,105,4769,0.06,24,1315,0.017,79444,POINT (-87.701816 41.971155),60625-20210131
60625,02/01/2021,219,6303,163,4932,0.062,56,1371,0.017,79444,POINT (-87.701816 41.971155),60625-20210201
60625,02/02/2021,332,6635,231,5163,0.065,101,1472,0.019,79444,POINT (-87.701816 41.971155),60625-20210202
60625,02/04/2021,374,7387,295,5721,0.072,79,1666,0.021,79444,POINT (-87.701816 41.971155),60625-20210204
60625,02/05/2021,385,7772,265,5986,0.075,120,1786,0.022,79444,POINT (-87.701816 41.971155),60625-20210205
60625,02/06/2021,255,8027,192,6178,0.078,63,1849,0.023,79444,POINT (-87.701816 41.971155),60625-20210206
60625,02/07/2021,67,8094,56,6234,0.078,11,1860,0.023,79444,POINT (-87.701816 41.971155),60625-20210207
60625,02/08/2021,226,8320,182,6416,0.081,44,1904,0.024,79444,POINT (-87.701816 41.971155),60625-20210208
60625,02/09/2021,298,8618,214,6630,0.083,84,1988,0.025,79444,POINT (-87.701816 41.971155),60625-20210209
60625,02/10/2021,474,9092,323,6953,0.088,151,2139,0.027,79444,POINT (-87.701816 41.971155),60625-20210210
60625,02/11/2021,467,9559,298,7251,0.091,169,2308,0.029,79444,POINT (-87.701816 41.971155),60625-20210211
60625,02/12/2021,436,9995,290,7541,0.095,146,2454,0.031,79444,POINT (-87.701816 41.971155),60625-20210212
60625,02/13/2021,326,10321,237,7778,0.098,89,2543,0.032,79444,POINT (-87.701816 41.971155),60625-20210213
60625,02/14/2021,105,10426,71,7849,0.099,34,2577,0.032,79444,POINT (-87.701816 41.971155),60625-20210214
60625,02/15/2021,282,10708,222,8071,0.102,60,2637,0.033,79444,POINT (-87.701816 41.971155),60625-20210215
60625,02/16/2021,148,10856,105,8176,0.103,43,2680,0.034,79444,POINT (-87.701816 41.971155),60625-20210216
60625,02/17/2021,411,11267,206,8382,0.106,205,2885,0.036,79444,POINT (-87.701816 41.971155),60625-20210217
60625,02/18/2021,416,11683,184,8566,0.108,232,3117,0.039,79444,POINT (-87.701816 41.971155),60625-20210218
60626,01/14/2021,272,2074,261,1771,0.035,11,303,0.006,50544,POINT (-87.669834 42.009469),60626-20210114
60626,01/15/2021,268,2342,257,2028,0.04,11,314,0.006,50544,POINT (-87.669834 42.009469),60626-20210115
60626,01/16/2021,52,2394,48,2076,0.041,4,318,0.006,50544,POINT (-87.669834 42.009469),60626-20210116
60626,01/17/2021,21,2415,14,2090,0.041,7,325,0.006,50544,POINT (-87.669834 42.009469),60626-20210117
60626,01/18/2021,236,2651,219,2309,0.046,17,342,0.007,50544,POINT (-87.669834 42.009469),60626-20210118
60626,01/19/2021,100,2751,63,2372,0.047,37,379,0.007,50544,POINT (-87.669834 42.009469),60626-20210119
60626,01/20/2021,143,2894,112,2484,0.049,31,410,0.008,50544,POINT (-87.669834 42.009469),60626-20210120
60626,01/21/2021,186,3080,153,2637,0.052,33,443,0.009,50544,POINT (-87.669834 42.009469),60626-20210121
60626,01/22/2021,154,3234,146,2783,0.055,8,451,0.009,50544,POINT (-87.669834 42.009469),60626-20210122
60626,01/23/2021,68,3302,66,2849,0.056,2,453,0.009,50544,POINT (-87.669834 42.009469),60626-20210123
60626,01/24/2021,26,3328,24,2873,0.057,2,455,0.009,50544,POINT (-87.669834 42.009469),60626-20210124
60626,01/25/2021,112,3440,77,2950,0.058,35,490,0.01,50544,POINT (-87.669834 42.009469),60626-20210125
60626,01/26/2021,155,3595,100,3050,0.06,55,545,0.011,50544,POINT (-87.669834 42.009469),60626-20210126
60626,01/27/2021,433,4028,174,3224,0.064,259,804,0.016,50544,POINT (-87.669834 42.009469),60626-20210127
60626,01/28/2021,163,4191,133,3357,0.066,30,834,0.017,50544,POINT (-87.669834 42.009469),60626-20210128
60626,01/29/2021,152,4343,140,3497,0.069,12,846,0.017,50544,POINT (-87.669834 42.009469),60626-20210129
60626,01/30/2021,105,4448,93,3590,0.071,12,858,0.017,50544,POINT (-87.669834 42.009469),60626-20210130
60626,01/31/2021,45,4493,31,3621,0.072,14,872,0.017,50544,POINT (-87.669834 42.009469),60626-20210131
60626,02/01/2021,183,4676,137,3758,0.074,46,918,0.018,50544,POINT (-87.669834 42.009469),60626-20210201
60626,02/02/2021,305,4981,157,3915,0.077,148,1066,0.021,50544,POINT (-87.669834 42.009469),60626-20210202
60626,02/03/2021,176,5157,115,4030,0.08,61,1127,0.022,50544,POINT (-87.669834 42.009469),60626-20210203
60626,02/04/2021,247,5404,169,4199,0.083,78,1205,0.024,50544,POINT (-87.669834 42.009469),60626-20210204
60626,02/05/2021,261,5665,165,4364,0.086,96,1301,0.026,50544,POINT (-87.669834 42.009469),60626-20210205
60626,02/06/2021,136,5801,80,4444,0.088,56,1357,0.027,50544,POINT (-87.669834 42.009469),60626-20210206
60626,02/07/2021,38,5839,30,4474,0.089,8,1365,0.027,50544,POINT (-87.669834 42.009469),60626-20210207
60626,02/08/2021,129,5968,103,4577,0.091,26,1391,0.028,50544,POINT (-87.669834 42.009469),60626-20210208
60626,02/09/2021,278,6246,162,4739,0.094,116,1507,0.03,50544,POINT (-87.669834 42.009469),60626-20210209
60626,02/10/2021,257,6503,156,4895,0.097,101,1608,0.032,50544,POINT (-87.669834 42.009469),60626-20210210
60626,02/11/2021,485,6988,175,5070,0.1,310,1918,0.038,50544,POINT (-87.669834 42.009469),60626-20210211
60626,02/12/2021,451,7439,182,5252,0.104,269,2187,0.043,50544,POINT (-87.669834 42.009469),60626-20210212
60626,02/13/2021,239,7678,198,5450,0.108,41,2228,0.044,50544,POINT (-87.669834 42.009469),60626-20210213
60626,02/14/2021,36,7714,25,5475,0.108,11,2239,0.044,50544,POINT (-87.669834 42.009469),60626-20210214
60626,02/15/2021,307,8021,105,5580,0.11,202,2441,0.048,50544,POINT (-87.669834 42.009469),60626-20210215
60626,02/16/2021,98,8119,59,5639,0.112,39,2480,0.049,50544,POINT (-87.669834 42.009469),60626-20210216
60626,02/17/2021,180,8299,81,5720,0.113,99,2579,0.051,50544,POINT (-87.669834 42.009469),60626-20210217
60626,02/18/2021,179,8478,90,5810,0.115,89,2668,0.053,50544,POINT (-87.669834 42.009469),60626-20210218
60628,01/25/2021,108,1451,88,1241,0.019,20,210,0.003,64254,POINT (-87.621537 41.694192),60628-20210125
60628,01/26/2021,117,1568,100,1341,0.021,17,227,0.004,64254,POINT (-87.621537 41.694192),60628-20210126
60628,01/27/2021,161,1729,150,1491,0.023,11,238,0.004,64254,POINT (-87.621537 41.694192),60628-20210127
60628,01/28/2021,180,1909,169,1660,0.026,11,249,0.004,64254,POINT (-87.621537 41.694192),60628-20210128
60628,01/29/2021,214,2123,196,1856,0.029,18,267,0.004,64254,POINT (-87.621537 41.694192),60628-20210129
60628,01/30/2021,104,2227,97,1953,0.03,7,274,0.004,64254,POINT (-87.621537 41.694192),60628-20210130
60628,01/31/2021,13,2240,10,1963,0.031,3,277,0.004,64254,POINT (-87.621537 41.694192),60628-20210131
60628,02/01/2021,219,2459,98,2061,0.032,121,398,0.006,64254,POINT (-87.621537 41.694192),60628-20210201
60628,02/02/2021,169,2628,142,2203,0.034,27,425,0.007,64254,POINT (-87.621537 41.694192),60628-20210202
60628,02/03/2021,161,2789,129,2332,0.036,32,457,0.007,64254,POINT (-87.621537 41.694192),60628-20210203
60628,02/04/2021,225,3014,192,2524,0.039,33,490,0.008,64254,POINT (-87.621537 41.694192),60628-20210204
60628,02/05/2021,205,3219,177,2701,0.042,28,518,0.008,64254,POINT (-87.621537 41.694192),60628-20210205
60628,02/06/2021,139,3358,119,2820,0.044,20,538,0.008,64254,POINT (-87.621537 41.694192),60628-20210206
60628,02/08/2021,166,3570,133,2998,0.047,33,572,0.009,64254,POINT (-87.621537 41.694192),60628-20210208
60628,02/09/2021,216,3786,161,3159,0.049,55,627,0.01,64254,POINT (-87.621537 41.694192),60628-20210209
60628,02/10/2021,269,4055,183,3342,0.052,86,713,0.011,64254,POINT (-87.621537 41.694192),60628-20210210
60628,02/11/2021,303,4358,214,3556,0.055,89,802,0.012,64254,POINT (-87.621537 41.694192),60628-20210211
60628,02/12/2021,230,4588,149,3705,0.058,81,883,0.014,64254,POINT (-87.621537 41.694192),60628-20210212
60628,02/13/2021,193,4781,145,3850,0.06,48,931,0.014,64254,POINT (-87.621537 41.694192),60628-20210213
60628,02/14/2021,32,4813,27,3877,0.06,5,936,0.015,64254,POINT (-87.621537 41.694192),60628-20210214
60628,02/15/2021,121,4934,70,3947,0.061,51,987,0.015,64254,POINT (-87.621537 41.694192),60628-20210215
60628,02/16/2021,75,5009,32,3979,0.062,43,1030,0.016,64254,POINT (-87.621537 41.694192),60628-20210216
60628,02/17/2021,224,5233,74,4053,0.063,150,1180,0.018,64254,POINT (-87.621537 41.694192),60628-20210217
60628,02/18/2021,207,5440,95,4148,0.065,112,1292,0.02,64254,POINT (-87.621537 41.694192),60628-20210218
60629,01/22/2021,187,2257,177,1845,0.017,10,412,0.004,110029,POINT (-87.711565 41.777061),60629-20210122
60629,01/23/2021,81,2338,75,1920,0.017,6,418,0.004,110029,POINT (-87.711565 41.777061),60629-20210123
60629,01/24/2021,20,2358,19,1939,0.018,1,419,0.004,110029,POINT (-87.711565 41.777061),60629-20210124
60629,01/25/2021,138,2496,110,2049,0.019,28,447,0.004,110029,POINT (-87.711565 41.777061),60629-20210125
60629,01/26/2021,186,2682,134,2183,0.02,52,499,0.005,110029,POINT (-87.711565 41.777061),60629-20210126
60629,01/27/2021,225,2907,193,2376,0.022,32,531,0.005,110029,POINT (-87.711565 41.777061),60629-20210127
60629,01/28/2021,236,3143,195,2571,0.023,41,572,0.005,110029,POINT (-87.711565 41.777061),60629-20210128
60629,01/29/2021,326,3469,296,2867,0.026,30,602,0.005,110029,POINT (-87.711565 41.777061),60629-20210129
60629,01/30/2021,170,3639,143,3010,0.027,27,629,0.006,110029,POINT (-87.711565 41.777061),60629-20210130
60629,01/31/2021,25,3664,19,3029,0.028,6,635,0.006,110029,POINT (-87.711565 41.777061),60629-20210131
60629,02/01/2021,200,3864,169,3198,0.029,31,666,0.006,110029,POINT (-87.711565 41.777061),60629-20210201
60629,02/02/2021,279,4143,225,3423,0.031,54,720,0.007,110029,POINT (-87.711565 41.777061),60629-20210202
60629,02/03/2021,366,4509,298,3721,0.034,68,788,0.007,110029,POINT (-87.711565 41.777061),60629-20210203
60629,02/04/2021,427,4936,369,4090,0.037,58,846,0.008,110029,POINT (-87.711565 41.777061),60629-20210204
60629,02/05/2021,471,5407,414,4504,0.041,57,903,0.008,110029,POINT (-87.711565 41.777061),60629-20210205
60629,02/06/2021,252,5659,214,4718,0.043,38,941,0.009,110029,POINT (-87.711565 41.777061),60629-20210206
60629,02/07/2021,50,5709,48,4766,0.043,2,943,0.009,110029,POINT (-87.711565 41.777061),60629-20210207
60629,02/08/2021,355,6064,322,5088,0.046,33,976,0.009,110029,POINT (-87.711565 41.777061),60629-20210208
60629,02/09/2021,346,6410,304,5392,0.049,42,1018,0.009,110029,POINT (-87.711565 41.777061),60629-20210209
60629,02/10/2021,434,6844,371,5763,0.052,63,1081,0.01,110029,POINT (-87.711565 41.777061),60629-20210210
60629,02/11/2021,531,7375,401,6164,0.056,130,1211,0.011,110029,POINT (-87.711565 41.777061),60629-20210211
60629,02/12/2021,425,7800,334,6498,0.059,91,1302,0.012,110029,POINT (-87.711565 41.777061),60629-20210212
60629,02/13/2021,378,8178,245,6743,0.061,133,1435,0.013,110029,POINT (-87.711565 41.777061),60629-20210213
60629,02/14/2021,43,8221,29,6772,0.062,14,1449,0.013,110029,POINT (-87.711565 41.777061),60629-20210214
60629,02/15/2021,350,8571,309,7081,0.064,41,1490,0.014,110029,POINT (-87.711565 41.777061),60629-20210215
60629,02/16/2021,244,8815,219,7300,0.066,25,1515,0.014,110029,POINT (-87.711565 41.777061),60629-20210216
60629,02/17/2021,432,9247,283,7583,0.069,149,1664,0.015,110029,POINT (-87.711565 41.777061),60629-20210217
60629,02/18/2021,400,9647,288,7871,0.072,112,1776,0.016,110029,POINT (-87.711565 41.777061),60629-20210218
60630,01/19/2021,87,2086,55,1604,0.028,32,482,0.009,56433,POINT (-87.759611 41.971261),60630-20210119
60630,01/20/2021,135,2221,88,1692,0.03,47,529,0.009,56433,POINT (-87.759611 41.971261),60630-20210120
60630,01/21/2021,164,2385,130,1822,0.032,34,563,0.01,56433,POINT (-87.759611 41.971261),60630-20210121
60630,01/22/2021,158,2543,142,1964,0.035,16,579,0.01,56433,POINT (-87.759611 41.971261),60630-20210122
60630,01/23/2021,107,2650,101,2065,0.037,6,585,0.01,56433,POINT (-87.759611 41.971261),60630-20210123
60630,01/24/2021,27,2677,22,2087,0.037,5,590,0.01,56433,POINT (-87.759611 41.971261),60630-20210124
60630,01/25/2021,132,2809,98,2185,0.039,34,624,0.011,56433,POINT (-87.759611 41.971261),60630-20210125
60630,01/26/2021,145,2954,95,2280,0.04,50,674,0.012,56433,POINT (-87.759611 41.971261),60630-20210126
60630,01/27/2021,213,3167,170,2450,0.043,43,717,0.013,56433,POINT (-87.759611 41.971261),60630-20210127
60630,01/28/2021,205,3372,164,2614,0.046,41,758,0.013,56433,POINT (-87.759611 41.971261),60630-20210128
60630,01/29/2021,195,3567,172,2786,0.049,23,781,0.014,56433,POINT (-87.759611 41.971261),60630-20210129
60630,01/30/2021,141,3708,128,2914,0.052,13,794,0.014,56433,POINT (-87.759611 41.971261),60630-20210130
60630,01/31/2021,56,3764,50,2964,0.053,6,800,0.014,56433,POINT (-87.759611 41.971261),60630-20210131
60630,02/01/2021,159,3923,109,3073,0.054,50,850,0.015,56433,POINT (-87.759611 41.971261),60630-20210201
60630,02/02/2021,327,4250,198,3271,0.058,129,979,0.017,56433,POINT (-87.759611 41.971261),60630-20210202
60630,02/03/2021,245,4495,181,3452,0.061,64,1043,0.018,56433,POINT (-87.759611 41.971261),60630-20210203
60630,02/04/2021,311,4806,249,3701,0.066,62,1105,0.02,56433,POINT (-87.759611 41.971261),60630-20210204
60630,02/05/2021,324,5130,249,3950,0.07,75,1180,0.021,56433,POINT (-87.759611 41.971261),60630-20210205
60630,02/06/2021,216,5346,165,4115,0.073,51,1231,0.022,56433,POINT (-87.759611 41.971261),60630-20210206
60630,02/07/2021,58,5404,51,4166,0.074,7,1238,0.022,56433,POINT (-87.759611 41.971261),60630-20210207
60630,02/08/2021,203,5607,164,4330,0.077,39,1277,0.023,56433,POINT (-87.759611 41.971261),60630-20210208
60630,02/09/2021,217,5824,165,4495,0.08,52,1329,0.024,56433,POINT (-87.759611 41.971261),60630-20210209
60630,02/10/2021,317,6141,254,4749,0.084,63,1392,0.025,56433,POINT (-87.759611 41.971261),60630-20210210
60630,02/11/2021,362,6503,254,5003,0.089,108,1500,0.027,56433,POINT (-87.759611 41.971261),60630-20210211
60630,02/12/2021,317,6820,234,5237,0.093,83,1583,0.028,56433,POINT (-87.759611 41.971261),60630-20210212
60630,02/13/2021,263,7083,189,5426,0.096,74,1657,0.029,56433,POINT (-87.759611 41.971261),60630-20210213
60630,02/14/2021,76,7159,59,5485,0.097,17,1674,0.03,56433,POINT (-87.759611 41.971261),60630-20210214
60630,02/15/2021,176,7335,146,5631,0.1,30,1704,0.03,56433,POINT (-87.759611 41.971261),60630-20210215
60630,02/16/2021,122,7457,89,5720,0.101,33,1737,0.031,56433,POINT (-87.759611 41.971261),60630-20210216
60630,02/17/2021,286,7743,160,5880,0.104,126,1863,0.033,56433,POINT (-87.759611 41.971261),60630-20210217
60630,02/18/2021,266,8009,135,6015,0.107,131,1994,0.035,56433,POINT (-87.759611 41.971261),60630-20210218
60631,01/22/2021,122,2061,109,1651,0.056,13,410,0.014,29529,POINT (-87.813371 41.995019),60631-20210122
60631,01/23/2021,82,2143,77,1728,0.059,5,415,0.014,29529,POINT (-87.813371 41.995019),60631-20210123
60631,01/24/2021,26,2169,22,1750,0.059,4,419,0.014,29529,POINT (-87.813371 41.995019),60631-20210124
60631,01/25/2021,103,2272,76,1826,0.062,27,446,0.015,29529,POINT (-87.813371 41.995019),60631-20210125
60631,01/26/2021,99,2371,72,1898,0.064,27,473,0.016,29529,POINT (-87.813371 41.995019),60631-20210126
60631,01/27/2021,166,2537,133,2031,0.069,33,506,0.017,29529,POINT (-87.813371 41.995019),60631-20210127
60631,01/28/2021,155,2692,129,2160,0.073,26,532,0.018,29529,POINT (-87.813371 41.995019),60631-20210128
60631,01/29/2021,147,2839,127,2287,0.077,20,552,0.019,29529,POINT (-87.813371 41.995019),60631-20210129
60631,01/30/2021,190,3029,113,2400,0.081,77,629,0.021,29529,POINT (-87.813371 41.995019),60631-20210130
60631,01/31/2021,32,3061,26,2426,0.082,6,635,0.022,29529,POINT (-87.813371 41.995019),60631-20210131
60631,02/01/2021,116,3177,85,2511,0.085,31,666,0.023,29529,POINT (-87.813371 41.995019),60631-20210201
60631,02/02/2021,168,3345,122,2633,0.089,46,712,0.024,29529,POINT (-87.813371 41.995019),60631-20210202
60631,02/03/2021,196,3541,157,2790,0.094,39,751,0.025,29529,POINT (-87.813371 41.995019),60631-20210203
60631,02/04/2021,201,3742,165,2955,0.1,36,787,0.027,29529,POINT (-87.813371 41.995019),60631-20210204
60631,02/05/2021,339,4081,224,3179,0.108,115,902,0.031,29529,POINT (-87.813371 41.995019),60631-20210205
60631,02/06/2021,422,4503,405,3584,0.121,17,919,0.031,29529,POINT (-87.813371 41.995019),60631-20210206
60631,02/07/2021,44,4547,37,3621,0.123,7,926,0.031,29529,POINT (-87.813371 41.995019),60631-20210207
60631,02/08/2021,160,4707,120,3741,0.127,40,966,0.033,29529,POINT (-87.813371 41.995019),60631-20210208
60631,02/09/2021,189,4896,145,3886,0.132,44,1010,0.034,29529,POINT (-87.813371 41.995019),60631-20210209
60631,02/10/2021,254,5150,159,4045,0.137,95,1105,0.037,29529,POINT (-87.813371 41.995019),60631-20210210
60631,02/11/2021,267,5417,179,4224,0.143,88,1193,0.04,29529,POINT (-87.813371 41.995019),60631-20210211
60631,02/12/2021,246,5663,192,4416,0.15,54,1247,0.042,29529,POINT (-87.813371 41.995019),60631-20210212
60631,02/13/2021,217,5880,117,4533,0.154,100,1347,0.046,29529,POINT (-87.813371 41.995019),60631-20210213
60631,02/14/2021,61,5941,51,4584,0.155,10,1357,0.046,29529,POINT (-87.813371 41.995019),60631-20210214
60631,02/15/2021,100,6041,73,4657,0.158,27,1384,0.047,29529,POINT (-87.813371 41.995019),60631-20210215
60631,02/16/2021,104,6145,63,4720,0.16,41,1425,0.048,29529,POINT (-87.813371 41.995019),60631-20210216
60631,02/17/2021,218,6363,94,4814,0.163,124,1549,0.052,29529,POINT (-87.813371 41.995019),60631-20210217
60631,02/18/2021,217,6580,81,4895,0.166,136,1685,0.057,29529,POINT (-87.813371 41.995019),60631-20210218
60632,01/22/2021,126,1625,117,1352,0.015,9,273,0.003,89857,POINT (-87.711251 41.810038),60632-20210122
60632,01/23/2021,87,1712,85,1437,0.016,2,275,0.003,89857,POINT (-87.711251 41.810038),60632-20210123
60632,01/24/2021,15,1727,14,1451,0.016,1,276,0.003,89857,POINT (-87.711251 41.810038),60632-20210124
60632,01/25/2021,123,1850,92,1543,0.017,31,307,0.003,89857,POINT (-87.711251 41.810038),60632-20210125
60632,01/26/2021,135,1985,100,1643,0.018,35,342,0.004,89857,POINT (-87.711251 41.810038),60632-20210126
60632,01/27/2021,275,2260,215,1858,0.021,60,402,0.004,89857,POINT (-87.711251 41.810038),60632-20210127
60632,01/28/2021,238,2498,202,2060,0.023,36,438,0.005,89857,POINT (-87.711251 41.810038),60632-20210128
60632,01/29/2021,292,2790,262,2322,0.026,30,468,0.005,89857,POINT (-87.711251 41.810038),60632-20210129
60632,01/30/2021,161,2951,145,2467,0.027,16,484,0.005,89857,POINT (-87.711251 41.810038),60632-20210130
60632,01/31/2021,19,2970,19,2486,0.028,0,484,0.005,89857,POINT (-87.711251 41.810038),60632-20210131
60632,02/01/2021,200,3170,176,2662,0.03,24,508,0.006,89857,POINT (-87.711251 41.810038),60632-20210201
60632,02/02/2021,285,3455,241,2903,0.032,44,552,0.006,89857,POINT (-87.711251 41.810038),60632-20210202
60632,02/03/2021,373,3828,337,3240,0.036,36,588,0.007,89857,POINT (-87.711251 41.810038),60632-20210203
60632,02/04/2021,414,4242,366,3606,0.04,48,636,0.007,89857,POINT (-87.711251 41.810038),60632-20210204
60632,02/05/2021,396,4638,363,3969,0.044,33,669,0.007,89857,POINT (-87.711251 41.810038),60632-20210205
60632,02/06/2021,268,4906,224,4193,0.047,44,713,0.008,89857,POINT (-87.711251 41.810038),60632-20210206
60632,02/07/2021,26,4932,23,4216,0.047,3,716,0.008,89857,POINT (-87.711251 41.810038),60632-20210207
60632,02/08/2021,290,5222,266,4482,0.05,24,740,0.008,89857,POINT (-87.711251 41.810038),60632-20210208
60632,02/09/2021,353,5575,307,4789,0.053,46,786,0.009,89857,POINT (-87.711251 41.810038),60632-20210209
60632,02/10/2021,381,5956,323,5112,0.057,58,844,0.009,89857,POINT (-87.711251 41.810038),60632-20210210
60632,02/11/2021,479,6435,389,5501,0.061,90,934,0.01,89857,POINT (-87.711251 41.810038),60632-20210211
60632,02/12/2021,406,6841,337,5838,0.065,69,1003,0.011,89857,POINT (-87.711251 41.810038),60632-20210212
60632,02/13/2021,273,7114,217,6055,0.067,56,1059,0.012,89857,POINT (-87.711251 41.810038),60632-20210213
60632,02/14/2021,37,7151,24,6079,0.068,13,1072,0.012,89857,POINT (-87.711251 41.810038),60632-20210214
60632,02/15/2021,354,7505,320,6399,0.071,34,1106,0.012,89857,POINT (-87.711251 41.810038),60632-20210215
60632,02/16/2021,297,7802,261,6660,0.074,36,1142,0.013,89857,POINT (-87.711251 41.810038),60632-20210216
60632,02/17/2021,324,8126,214,6874,0.076,110,1252,0.014,89857,POINT (-87.711251 41.810038),60632-20210217
60632,02/18/2021,385,8511,286,7160,0.08,99,1351,0.015,89857,POINT (-87.711251 41.810038),60632-20210218
60633,02/13/2021,20,862,10,690,0.054,10,172,0.014,12689,POINT (-87.556037 41.653147),60633-20210213
60633,02/14/2021,14,876,14,704,0.055,0,172,0.014,12689,POINT (-87.556037 41.653147),60633-20210214
60633,02/15/2021,13,889,9,713,0.056,4,176,0.014,12689,POINT (-87.556037 41.653147),60633-20210215
60633,02/16/2021,14,903,5,718,0.057,9,185,0.015,12689,POINT (-87.556037 41.653147),60633-20210216
60633,02/17/2021,46,949,25,743,0.059,21,206,0.016,12689,POINT (-87.556037 41.653147),60633-20210217
60633,02/18/2021,35,984,18,761,0.06,17,223,0.018,12689,POINT (-87.556037 41.653147),60633-20210218
60634,01/15/2021,198,2315,197,1895,0.025,1,420,0.006,75082,POINT (-87.797373 41.944967),60634-20210115
60634,01/16/2021,152,2467,144,2039,0.027,8,428,0.006,75082,POINT (-87.797373 41.944967),60634-20210116
60634,01/17/2021,23,2490,11,2050,0.027,12,440,0.006,75082,POINT (-87.797373 41.944967),60634-20210117
60634,01/18/2021,60,2550,44,2094,0.028,16,456,0.006,75082,POINT (-87.797373 41.944967),60634-20210118
60634,01/19/2021,133,2683,85,2179,0.029,48,504,0.007,75082,POINT (-87.797373 41.944967),60634-20210119
60634,01/20/2021,222,2905,172,2351,0.031,50,554,0.007,75082,POINT (-87.797373 41.944967),60634-20210120
60634,01/21/2021,175,3080,136,2487,0.033,39,593,0.008,75082,POINT (-87.797373 41.944967),60634-20210121
60634,01/22/2021,177,3257,165,2652,0.035,12,605,0.008,75082,POINT (-87.797373 41.944967),60634-20210122
60634,01/23/2021,103,3360,90,2742,0.037,13,618,0.008,75082,POINT (-87.797373 41.944967),60634-20210123
60634,01/24/2021,40,3400,34,2776,0.037,6,624,0.008,75082,POINT (-87.797373 41.944967),60634-20210124
60634,01/25/2021,192,3592,143,2919,0.039,49,673,0.009,75082,POINT (-87.797373 41.944967),60634-20210125
60634,01/26/2021,176,3768,110,3029,0.04,66,739,0.01,75082,POINT (-87.797373 41.944967),60634-20210126
60631,01/20/2021,122,1827,94,1441,0.049,28,386,0.013,29529,POINT (-87.813371 41.995019),60631-20210120
60631,01/21/2021,112,1939,101,1542,0.052,11,397,0.013,29529,POINT (-87.813371 41.995019),60631-20210121
60634,01/27/2021,226,3994,172,3201,0.043,54,793,0.011,75082,POINT (-87.797373 41.944967),60634-20210127
60634,01/28/2021,282,4276,220,3421,0.046,62,855,0.011,75082,POINT (-87.797373 41.944967),60634-20210128
60634,01/29/2021,197,4473,174,3595,0.048,23,878,0.012,75082,POINT (-87.797373 41.944967),60634-20210129
60634,01/31/2021,52,4750,45,3774,0.05,7,976,0.013,75082,POINT (-87.797373 41.944967),60634-20210131
60634,02/01/2021,179,4929,132,3906,0.052,47,1023,0.014,75082,POINT (-87.797373 41.944967),60634-20210201
60634,02/02/2021,317,5246,223,4129,0.055,94,1117,0.015,75082,POINT (-87.797373 41.944967),60634-20210202
60634,02/03/2021,292,5538,220,4349,0.058,72,1189,0.016,75082,POINT (-87.797373 41.944967),60634-20210203
60634,02/04/2021,362,5900,298,4647,0.062,64,1253,0.017,75082,POINT (-87.797373 41.944967),60634-20210204
60634,02/05/2021,558,6458,321,4968,0.066,237,1490,0.02,75082,POINT (-87.797373 41.944967),60634-20210205
60634,02/06/2021,280,6738,250,5218,0.069,30,1520,0.02,75082,POINT (-87.797373 41.944967),60634-20210206
60634,02/07/2021,69,6807,55,5273,0.07,14,1534,0.02,75082,POINT (-87.797373 41.944967),60634-20210207
60634,02/08/2021,233,7040,188,5461,0.073,45,1579,0.021,75082,POINT (-87.797373 41.944967),60634-20210208
60634,02/09/2021,323,7363,253,5714,0.076,70,1649,0.022,75082,POINT (-87.797373 41.944967),60634-20210209
60634,02/10/2021,389,7752,249,5963,0.079,140,1789,0.024,75082,POINT (-87.797373 41.944967),60634-20210210
60634,02/11/2021,504,8256,341,6304,0.084,163,1952,0.026,75082,POINT (-87.797373 41.944967),60634-20210211
60634,02/12/2021,427,8683,314,6618,0.088,113,2065,0.028,75082,POINT (-87.797373 41.944967),60634-20210212
60634,02/13/2021,424,9107,283,6901,0.092,141,2206,0.029,75082,POINT (-87.797373 41.944967),60634-20210213
60634,02/14/2021,146,9253,132,7033,0.094,14,2220,0.03,75082,POINT (-87.797373 41.944967),60634-20210214
60634,02/15/2021,180,9433,143,7176,0.096,37,2257,0.03,75082,POINT (-87.797373 41.944967),60634-20210215
60634,02/16/2021,151,9584,101,7277,0.097,50,2307,0.031,75082,POINT (-87.797373 41.944967),60634-20210216
60634,02/17/2021,334,9918,182,7459,0.099,152,2459,0.033,75082,POINT (-87.797373 41.944967),60634-20210217
60634,02/18/2021,339,10257,163,7622,0.102,176,2635,0.035,75082,POINT (-87.797373 41.944967),60634-20210218
60636,01/20/2021,28,308,20,263,0.009,8,45,0.001,30024,POINT (-87.668597 41.77599),60636-20210120
60636,01/21/2021,64,372,53,316,0.011,11,56,0.002,30024,POINT (-87.668597 41.77599),60636-20210121
60636,01/22/2021,75,447,71,387,0.013,4,60,0.002,30024,POINT (-87.668597 41.77599),60636-20210122
60636,01/23/2021,11,458,11,398,0.013,0,60,0.002,30024,POINT (-87.668597 41.77599),60636-20210123
60636,01/24/2021,13,471,10,408,0.014,3,63,0.002,30024,POINT (-87.668597 41.77599),60636-20210124
60636,01/25/2021,51,522,39,447,0.015,12,75,0.002,30024,POINT (-87.668597 41.77599),60636-20210125
60636,01/26/2021,46,568,40,487,0.016,6,81,0.003,30024,POINT (-87.668597 41.77599),60636-20210126
60636,01/27/2021,61,629,52,539,0.018,9,90,0.003,30024,POINT (-87.668597 41.77599),60636-20210127
60636,01/28/2021,57,686,54,593,0.02,3,93,0.003,30024,POINT (-87.668597 41.77599),60636-20210128
60636,01/29/2021,105,791,99,692,0.023,6,99,0.003,30024,POINT (-87.668597 41.77599),60636-20210129
60636,01/30/2021,26,817,24,716,0.024,2,101,0.003,30024,POINT (-87.668597 41.77599),60636-20210130
60636,01/31/2021,3,820,2,718,0.024,1,102,0.003,30024,POINT (-87.668597 41.77599),60636-20210131
60636,02/01/2021,36,856,32,750,0.025,4,106,0.004,30024,POINT (-87.668597 41.77599),60636-20210201
60636,02/02/2021,48,904,37,787,0.026,11,117,0.004,30024,POINT (-87.668597 41.77599),60636-20210202
60636,02/03/2021,62,966,48,835,0.028,14,131,0.004,30024,POINT (-87.668597 41.77599),60636-20210203
60636,02/04/2021,82,1048,70,905,0.03,12,143,0.005,30024,POINT (-87.668597 41.77599),60636-20210204
60636,02/05/2021,75,1123,64,969,0.032,11,154,0.005,30024,POINT (-87.668597 41.77599),60636-20210205
60636,02/06/2021,32,1155,28,997,0.033,4,158,0.005,30024,POINT (-87.668597 41.77599),60636-20210206
60636,02/07/2021,14,1169,14,1011,0.034,0,158,0.005,30024,POINT (-87.668597 41.77599),60636-20210207
60636,02/08/2021,62,1231,50,1061,0.035,12,170,0.006,30024,POINT (-87.668597 41.77599),60636-20210208
60636,02/09/2021,79,1310,65,1126,0.038,14,184,0.006,30024,POINT (-87.668597 41.77599),60636-20210209
60636,02/10/2021,93,1403,76,1202,0.04,17,201,0.007,30024,POINT (-87.668597 41.77599),60636-20210210
60636,02/11/2021,101,1504,69,1271,0.042,32,233,0.008,30024,POINT (-87.668597 41.77599),60636-20210211
60636,02/12/2021,69,1573,55,1326,0.044,14,247,0.008,30024,POINT (-87.668597 41.77599),60636-20210212
60636,02/13/2021,73,1646,61,1387,0.046,12,259,0.009,30024,POINT (-87.668597 41.77599),60636-20210213
60636,02/14/2021,6,1652,5,1392,0.046,1,260,0.009,30024,POINT (-87.668597 41.77599),60636-20210214
60636,02/15/2021,51,1703,36,1428,0.048,15,275,0.009,30024,POINT (-87.668597 41.77599),60636-20210215
60636,02/16/2021,31,1734,17,1445,0.048,14,289,0.01,30024,POINT (-87.668597 41.77599),60636-20210216
60636,02/17/2021,87,1821,49,1494,0.05,38,327,0.011,30024,POINT (-87.668597 41.77599),60636-20210217
60636,02/18/2021,87,1908,42,1536,0.051,45,372,0.012,30024,POINT (-87.668597 41.77599),60636-20210218
60637,01/22/2021,194,2740,166,2118,0.045,28,622,0.013,47300,POINT (-87.604053 41.780991),60637-20210122
60637,01/23/2021,132,2872,90,2208,0.047,42,664,0.014,47300,POINT (-87.604053 41.780991),60637-20210123
60637,01/24/2021,48,2920,45,2253,0.048,3,667,0.014,47300,POINT (-87.604053 41.780991),60637-20210124
60637,01/25/2021,178,3098,133,2386,0.05,45,712,0.015,47300,POINT (-87.604053 41.780991),60637-20210125
60637,01/26/2021,147,3245,107,2493,0.053,40,752,0.016,47300,POINT (-87.604053 41.780991),60637-20210126
60637,01/27/2021,130,3375,100,2593,0.055,30,782,0.017,47300,POINT (-87.604053 41.780991),60637-20210127
60634,12/15/2020,0,0,0,0,0,0,0,0,75082,POINT (-87.797373 41.944967),60634-20201215
60634,12/16/2020,1,1,1,1,0,0,0,0,75082,POINT (-87.797373 41.944967),60634-20201216
60634,12/17/2020,29,30,29,30,0,0,0,0,75082,POINT (-87.797373 41.944967),60634-20201217
60634,12/18/2020,105,135,105,135,0.002,0,0,0,75082,POINT (-87.797373 41.944967),60634-20201218
60634,12/19/2020,74,209,74,209,0.003,0,0,0,75082,POINT (-87.797373 41.944967),60634-20201219
60634,12/20/2020,20,229,20,229,0.003,0,0,0,75082,POINT (-87.797373 41.944967),60634-20201220
60634,12/21/2020,97,326,97,326,0.004,0,0,0,75082,POINT (-87.797373 41.944967),60634-20201221
60634,12/22/2020,71,397,71,397,0.005,0,0,0,75082,POINT (-87.797373 41.944967),60634-20201222
60634,12/23/2020,53,450,53,450,0.006,0,0,0,75082,POINT (-87.797373 41.944967),60634-20201223
60634,12/24/2020,7,457,7,457,0.006,0,0,0,75082,POINT (-87.797373 41.944967),60634-20201224
60634,12/25/2020,0,457,0,457,0.006,0,0,0,75082,POINT (-87.797373 41.944967),60634-20201225
60634,12/26/2020,9,466,9,466,0.006,0,0,0,75082,POINT (-87.797373 41.944967),60634-20201226
60634,12/27/2020,0,466,0,466,0.006,0,0,0,75082,POINT (-87.797373 41.944967),60634-20201227
60634,12/28/2020,25,491,25,491,0.007,0,0,0,75082,POINT (-87.797373 41.944967),60634-20201228
60634,12/29/2020,106,597,106,597,0.008,0,0,0,75082,POINT (-87.797373 41.944967),60634-20201229
60634,12/30/2020,73,670,73,670,0.009,0,0,0,75082,POINT (-87.797373 41.944967),60634-20201230
60634,12/31/2020,56,726,56,726,0.01,0,0,0,75082,POINT (-87.797373 41.944967),60634-20201231
60634,01/01/2021,1,727,1,727,0.01,0,0,0,75082,POINT (-87.797373 41.944967),60634-20210101
60634,01/02/2021,110,837,110,837,0.011,0,0,0,75082,POINT (-87.797373 41.944967),60634-20210102
60634,01/03/2021,16,853,16,853,0.011,0,0,0,75082,POINT (-87.797373 41.944967),60634-20210103
60634,01/04/2021,99,952,98,951,0.013,1,1,0,75082,POINT (-87.797373 41.944967),60634-20210104
60634,01/05/2021,94,1046,89,1040,0.014,5,6,0,75082,POINT (-87.797373 41.944967),60634-20210105
60634,01/06/2021,71,1117,56,1096,0.015,15,21,0,75082,POINT (-87.797373 41.944967),60634-20210106
60634,01/07/2021,119,1236,57,1153,0.015,62,83,0.001,75082,POINT (-87.797373 41.944967),60634-20210107
60634,01/08/2021,320,1556,218,1371,0.018,102,185,0.002,75082,POINT (-87.797373 41.944967),60634-20210108
60634,01/09/2021,73,1629,31,1402,0.019,42,227,0.003,75082,POINT (-87.797373 41.944967),60634-20210109
60634,01/10/2021,29,1658,12,1414,0.019,17,244,0.003,75082,POINT (-87.797373 41.944967),60634-20210110
60634,01/11/2021,101,1759,46,1460,0.019,55,299,0.004,75082,POINT (-87.797373 41.944967),60634-20210111
60634,01/12/2021,129,1888,72,1532,0.02,57,356,0.005,75082,POINT (-87.797373 41.944967),60634-20210112
60634,01/13/2021,146,2034,95,1627,0.022,51,407,0.005,75082,POINT (-87.797373 41.944967),60634-20210113
60634,01/14/2021,83,2117,71,1698,0.023,12,419,0.006,75082,POINT (-87.797373 41.944967),60634-20210114
60637,01/28/2021,142,3517,112,2705,0.057,30,812,0.017,47300,POINT (-87.604053 41.780991),60637-20210128
60637,01/29/2021,142,3659,129,2834,0.06,13,825,0.017,47300,POINT (-87.604053 41.780991),60637-20210129
60637,01/30/2021,67,3726,49,2883,0.061,18,843,0.018,47300,POINT (-87.604053 41.780991),60637-20210130
60637,01/31/2021,68,3794,67,2950,0.062,1,844,0.018,47300,POINT (-87.604053 41.780991),60637-20210131
60637,02/01/2021,76,3870,51,3001,0.063,25,869,0.018,47300,POINT (-87.604053 41.780991),60637-20210201
60637,02/02/2021,93,3963,75,3076,0.065,18,887,0.019,47300,POINT (-87.604053 41.780991),60637-20210202
60637,02/03/2021,194,4157,151,3227,0.068,43,930,0.02,47300,POINT (-87.604053 41.780991),60637-20210203
60637,02/04/2021,185,4342,109,3336,0.071,76,1006,0.021,47300,POINT (-87.604053 41.780991),60637-20210204
60637,02/05/2021,175,4517,105,3441,0.073,70,1076,0.023,47300,POINT (-87.604053 41.780991),60637-20210205
60637,02/06/2021,119,4636,59,3500,0.074,60,1136,0.024,47300,POINT (-87.604053 41.780991),60637-20210206
60637,02/07/2021,75,4711,74,3574,0.076,1,1137,0.024,47300,POINT (-87.604053 41.780991),60637-20210207
60637,02/08/2021,181,4892,69,3643,0.077,112,1249,0.026,47300,POINT (-87.604053 41.780991),60637-20210208
60637,02/09/2021,145,5037,47,3690,0.078,98,1347,0.028,47300,POINT (-87.604053 41.780991),60637-20210209
60637,02/10/2021,197,5234,87,3777,0.08,110,1457,0.031,47300,POINT (-87.604053 41.780991),60637-20210210
60637,02/11/2021,291,5525,82,3859,0.082,209,1666,0.035,47300,POINT (-87.604053 41.780991),60637-20210211
60637,02/12/2021,294,5819,74,3933,0.083,220,1886,0.04,47300,POINT (-87.604053 41.780991),60637-20210212
60637,02/13/2021,134,5953,66,3999,0.085,68,1954,0.041,47300,POINT (-87.604053 41.780991),60637-20210213
60636,01/19/2021,23,280,18,243,0.008,5,37,0.001,30024,POINT (-87.668597 41.77599),60636-20210119
60637,02/14/2021,13,5966,13,4012,0.085,0,1954,0.041,47300,POINT (-87.604053 41.780991),60637-20210214
60637,02/15/2021,116,6082,41,4053,0.086,75,2029,0.043,47300,POINT (-87.604053 41.780991),60637-20210215
60637,02/16/2021,77,6159,25,4078,0.086,52,2081,0.044,47300,POINT (-87.604053 41.780991),60637-20210216
60637,02/17/2021,123,6282,30,4108,0.087,93,2174,0.046,47300,POINT (-87.604053 41.780991),60637-20210217
60637,02/18/2021,132,6414,42,4150,0.088,90,2264,0.048,47300,POINT (-87.604053 41.780991),60637-20210218
60638,01/22/2021,164,1998,150,1541,0.026,14,457,0.008,58669,POINT (-87.771902 41.787032),60638-20210122
60638,01/23/2021,111,2109,108,1649,0.028,3,460,0.008,58669,POINT (-87.771902 41.787032),60638-20210123
60638,01/24/2021,33,2142,31,1680,0.029,2,462,0.008,58669,POINT (-87.771902 41.787032),60638-20210124
60638,01/25/2021,117,2259,82,1762,0.03,35,497,0.008,58669,POINT (-87.771902 41.787032),60638-20210125
60638,01/26/2021,145,2404,99,1861,0.032,46,543,0.009,58669,POINT (-87.771902 41.787032),60638-20210126
60638,01/27/2021,207,2611,181,2042,0.035,26,569,0.01,58669,POINT (-87.771902 41.787032),60638-20210127
60638,01/28/2021,218,2829,187,2229,0.038,31,600,0.01,58669,POINT (-87.771902 41.787032),60638-20210128
60638,01/29/2021,241,3070,218,2447,0.042,23,623,0.011,58669,POINT (-87.771902 41.787032),60638-20210129
60638,01/30/2021,154,3224,134,2581,0.044,20,643,0.011,58669,POINT (-87.771902 41.787032),60638-20210130
60638,01/31/2021,27,3251,21,2602,0.044,6,649,0.011,58669,POINT (-87.771902 41.787032),60638-20210131
60638,02/01/2021,157,3408,133,2735,0.047,24,673,0.011,58669,POINT (-87.771902 41.787032),60638-20210201
60638,02/02/2021,256,3664,201,2936,0.05,55,728,0.012,58669,POINT (-87.771902 41.787032),60638-20210202
60638,02/03/2021,277,3941,231,3167,0.054,46,774,0.013,58669,POINT (-87.771902 41.787032),60638-20210203
60638,02/04/2021,306,4247,275,3442,0.059,31,805,0.014,58669,POINT (-87.771902 41.787032),60638-20210204
60638,02/05/2021,313,4560,270,3712,0.063,43,848,0.014,58669,POINT (-87.771902 41.787032),60638-20210205
60638,02/06/2021,171,4731,147,3859,0.066,24,872,0.015,58669,POINT (-87.771902 41.787032),60638-20210206
60638,02/07/2021,52,4783,50,3909,0.067,2,874,0.015,58669,POINT (-87.771902 41.787032),60638-20210207
60638,02/08/2021,199,4982,167,4076,0.069,32,906,0.015,58669,POINT (-87.771902 41.787032),60638-20210208
60638,02/09/2021,285,5267,224,4300,0.073,61,967,0.016,58669,POINT (-87.771902 41.787032),60638-20210209
60638,02/10/2021,328,5595,252,4552,0.078,76,1043,0.018,58669,POINT (-87.771902 41.787032),60638-20210210
60638,02/11/2021,343,5938,237,4789,0.082,106,1149,0.02,58669,POINT (-87.771902 41.787032),60638-20210211
60638,02/12/2021,316,6254,242,5031,0.086,74,1223,0.021,58669,POINT (-87.771902 41.787032),60638-20210212
60638,02/13/2021,224,6478,140,5171,0.088,84,1307,0.022,58669,POINT (-87.771902 41.787032),60638-20210213
60638,02/14/2021,39,6517,24,5195,0.089,15,1322,0.023,58669,POINT (-87.771902 41.787032),60638-20210214
60638,02/15/2021,186,6703,142,5337,0.091,44,1366,0.023,58669,POINT (-87.771902 41.787032),60638-20210215
60638,02/16/2021,169,6872,122,5459,0.093,47,1413,0.024,58669,POINT (-87.771902 41.787032),60638-20210216
60638,02/17/2021,246,7118,116,5575,0.095,130,1543,0.026,58669,POINT (-87.771902 41.787032),60638-20210217
60638,02/18/2021,320,7438,168,5743,0.098,152,1695,0.029,58669,POINT (-87.771902 41.787032),60638-20210218
60639,01/20/2021,158,1660,115,1376,0.016,43,284,0.003,88204,POINT (-87.75531 41.920609),60639-20210120
60639,01/21/2021,174,1834,149,1525,0.017,25,309,0.004,88204,POINT (-87.75531 41.920609),60639-20210121
60639,01/22/2021,151,1985,144,1669,0.019,7,316,0.004,88204,POINT (-87.75531 41.920609),60639-20210122
60639,01/23/2021,56,2041,45,1714,0.019,11,327,0.004,88204,POINT (-87.75531 41.920609),60639-20210123
60639,01/24/2021,15,2056,13,1727,0.02,2,329,0.004,88204,POINT (-87.75531 41.920609),60639-20210124
60639,01/25/2021,109,2165,67,1794,0.02,42,371,0.004,88204,POINT (-87.75531 41.920609),60639-20210125
60639,01/26/2021,120,2285,79,1873,0.021,41,412,0.005,88204,POINT (-87.75531 41.920609),60639-20210126
60639,01/27/2021,190,2475,141,2014,0.023,49,461,0.005,88204,POINT (-87.75531 41.920609),60639-20210127
60639,01/28/2021,183,2658,148,2162,0.025,35,496,0.006,88204,POINT (-87.75531 41.920609),60639-20210128
60639,01/29/2021,191,2849,159,2321,0.026,32,528,0.006,88204,POINT (-87.75531 41.920609),60639-20210129
60639,01/30/2021,150,2999,135,2456,0.028,15,543,0.006,88204,POINT (-87.75531 41.920609),60639-20210130
60639,01/31/2021,39,3038,33,2489,0.028,6,549,0.006,88204,POINT (-87.75531 41.920609),60639-20210131
60639,02/01/2021,170,3208,141,2630,0.03,29,578,0.007,88204,POINT (-87.75531 41.920609),60639-20210201
60639,02/02/2021,216,3424,153,2783,0.032,63,641,0.007,88204,POINT (-87.75531 41.920609),60639-20210202
60639,02/03/2021,264,3688,208,2991,0.034,56,697,0.008,88204,POINT (-87.75531 41.920609),60639-20210203
60639,02/04/2021,314,4002,269,3260,0.037,45,742,0.008,88204,POINT (-87.75531 41.920609),60639-20210204
60639,02/05/2021,306,4308,253,3513,0.04,53,795,0.009,88204,POINT (-87.75531 41.920609),60639-20210205
60639,02/06/2021,311,4619,274,3787,0.043,37,832,0.009,88204,POINT (-87.75531 41.920609),60639-20210206
60639,02/07/2021,115,4734,59,3846,0.044,56,888,0.01,88204,POINT (-87.75531 41.920609),60639-20210207
60639,02/08/2021,239,4973,165,4011,0.045,74,962,0.011,88204,POINT (-87.75531 41.920609),60639-20210208
60639,02/09/2021,239,5212,191,4202,0.048,48,1010,0.011,88204,POINT (-87.75531 41.920609),60639-20210209
60639,02/10/2021,274,5486,210,4412,0.05,64,1074,0.012,88204,POINT (-87.75531 41.920609),60639-20210210
60639,02/11/2021,333,5819,227,4639,0.053,106,1180,0.013,88204,POINT (-87.75531 41.920609),60639-20210211
60639,02/12/2021,313,6132,236,4875,0.055,77,1257,0.014,88204,POINT (-87.75531 41.920609),60639-20210212
60639,02/13/2021,879,7011,836,5711,0.065,43,1300,0.015,88204,POINT (-87.75531 41.920609),60639-20210213
60639,02/14/2021,710,7721,706,6417,0.073,4,1304,0.015,88204,POINT (-87.75531 41.920609),60639-20210214
60639,02/15/2021,177,7898,135,6552,0.074,42,1346,0.015,88204,POINT (-87.75531 41.920609),60639-20210215
60639,02/16/2021,127,8025,88,6640,0.075,39,1385,0.016,88204,POINT (-87.75531 41.920609),60639-20210216
60639,02/17/2021,218,8243,99,6739,0.076,119,1504,0.017,88204,POINT (-87.75531 41.920609),60639-20210217
60639,02/18/2021,247,8490,123,6862,0.078,124,1628,0.018,88204,POINT (-87.75531 41.920609),60639-20210218
60640,01/27/2021,645,6785,481,5425,0.078,164,1360,0.02,69363,POINT (-87.662232 41.971888),60640-20210127
60640,01/28/2021,529,7314,471,5896,0.085,58,1418,0.02,69363,POINT (-87.662232 41.971888),60640-20210128
60640,01/29/2021,424,7738,385,6281,0.091,39,1457,0.021,69363,POINT (-87.662232 41.971888),60640-20210129
60640,01/30/2021,159,7897,129,6410,0.092,30,1487,0.021,69363,POINT (-87.662232 41.971888),60640-20210130
60640,01/31/2021,134,8031,61,6471,0.093,73,1560,0.022,69363,POINT (-87.662232 41.971888),60640-20210131
60640,02/01/2021,380,8411,267,6738,0.097,113,1673,0.024,69363,POINT (-87.662232 41.971888),60640-20210201
60640,02/02/2021,298,8709,176,6914,0.1,122,1795,0.026,69363,POINT (-87.662232 41.971888),60640-20210202
60640,02/03/2021,525,9234,310,7224,0.104,215,2010,0.029,69363,POINT (-87.662232 41.971888),60640-20210203
60640,02/04/2021,479,9713,319,7543,0.109,160,2170,0.031,69363,POINT (-87.662232 41.971888),60640-20210204
60640,02/05/2021,643,10356,350,7893,0.114,293,2463,0.036,69363,POINT (-87.662232 41.971888),60640-20210205
60640,02/06/2021,214,10570,138,8031,0.116,76,2539,0.037,69363,POINT (-87.662232 41.971888),60640-20210206
60640,02/07/2021,66,10636,53,8084,0.117,13,2552,0.037,69363,POINT (-87.662232 41.971888),60640-20210207
60640,02/08/2021,368,11004,217,8301,0.12,151,2703,0.039,69363,POINT (-87.662232 41.971888),60640-20210208
60640,02/09/2021,296,11300,205,8506,0.123,91,2794,0.04,69363,POINT (-87.662232 41.971888),60640-20210209
60640,02/10/2021,536,11836,300,8806,0.127,236,3030,0.044,69363,POINT (-87.662232 41.971888),60640-20210210
60640,02/11/2021,516,12352,255,9061,0.131,261,3291,0.047,69363,POINT (-87.662232 41.971888),60640-20210211
60640,02/12/2021,442,12794,281,9342,0.135,161,3452,0.05,69363,POINT (-87.662232 41.971888),60640-20210212
60640,02/13/2021,284,13078,205,9547,0.138,79,3531,0.051,69363,POINT (-87.662232 41.971888),60640-20210213
60640,02/14/2021,105,13183,69,9616,0.139,36,3567,0.051,69363,POINT (-87.662232 41.971888),60640-20210214
60640,02/15/2021,192,13375,134,9750,0.141,58,3625,0.052,69363,POINT (-87.662232 41.971888),60640-20210215
60640,02/16/2021,221,13596,169,9919,0.143,52,3677,0.053,69363,POINT (-87.662232 41.971888),60640-20210216
60640,02/17/2021,428,14024,180,10099,0.146,248,3925,0.057,69363,POINT (-87.662232 41.971888),60640-20210217
60640,02/18/2021,597,14621,229,10328,0.149,368,4293,0.062,69363,POINT (-87.662232 41.971888),60640-20210218
60641,01/21/2021,170,2533,138,1946,0.028,32,587,0.008,69880,POINT (-87.746791 41.946682),60641-20210121
60641,01/22/2021,195,2728,179,2125,0.03,16,603,0.009,69880,POINT (-87.746791 41.946682),60641-20210122
60641,01/23/2021,96,2824,89,2214,0.032,7,610,0.009,69880,POINT (-87.746791 41.946682),60641-20210123
60641,01/24/2021,34,2858,32,2246,0.032,2,612,0.009,69880,POINT (-87.746791 41.946682),60641-20210124
60641,01/25/2021,166,3024,130,2376,0.034,36,648,0.009,69880,POINT (-87.746791 41.946682),60641-20210125
60641,01/26/2021,168,3192,112,2488,0.036,56,704,0.01,69880,POINT (-87.746791 41.946682),60641-20210126
60641,01/27/2021,208,3400,162,2650,0.038,46,750,0.011,69880,POINT (-87.746791 41.946682),60641-20210127
60641,01/28/2021,238,3638,200,2850,0.041,38,788,0.011,69880,POINT (-87.746791 41.946682),60641-20210128
60641,01/29/2021,209,3847,185,3035,0.043,24,812,0.012,69880,POINT (-87.746791 41.946682),60641-20210129
60641,01/30/2021,163,4010,136,3171,0.045,27,839,0.012,69880,POINT (-87.746791 41.946682),60641-20210130
60641,01/31/2021,50,4060,40,3211,0.046,10,849,0.012,69880,POINT (-87.746791 41.946682),60641-20210131
60641,02/01/2021,237,4297,163,3374,0.048,74,923,0.013,69880,POINT (-87.746791 41.946682),60641-20210201
60641,02/02/2021,243,4540,158,3532,0.051,85,1008,0.014,69880,POINT (-87.746791 41.946682),60641-20210202
60641,02/03/2021,277,4817,207,3739,0.054,70,1078,0.015,69880,POINT (-87.746791 41.946682),60641-20210203
60641,02/04/2021,307,5124,255,3994,0.057,52,1130,0.016,69880,POINT (-87.746791 41.946682),60641-20210204
60641,02/05/2021,345,5469,269,4263,0.061,76,1206,0.017,69880,POINT (-87.746791 41.946682),60641-20210205
60641,02/06/2021,292,5761,233,4496,0.064,59,1265,0.018,69880,POINT (-87.746791 41.946682),60641-20210206
60641,02/07/2021,66,5827,54,4550,0.065,12,1277,0.018,69880,POINT (-87.746791 41.946682),60641-20210207
60641,02/08/2021,226,6053,192,4742,0.068,34,1311,0.019,69880,POINT (-87.746791 41.946682),60641-20210208
60641,02/09/2021,254,6307,204,4946,0.071,50,1361,0.019,69880,POINT (-87.746791 41.946682),60641-20210209
60641,02/10/2021,344,6651,256,5202,0.074,88,1449,0.021,69880,POINT (-87.746791 41.946682),60641-20210210
60641,02/11/2021,397,7048,282,5484,0.078,115,1564,0.022,69880,POINT (-87.746791 41.946682),60641-20210211
60641,02/12/2021,380,7428,289,5773,0.083,91,1655,0.024,69880,POINT (-87.746791 41.946682),60641-20210212
60641,02/13/2021,273,7701,210,5983,0.086,63,1718,0.025,69880,POINT (-87.746791 41.946682),60641-20210213
60641,02/14/2021,76,7777,59,6042,0.086,17,1735,0.025,69880,POINT (-87.746791 41.946682),60641-20210214
60641,02/15/2021,203,7980,144,6186,0.089,59,1794,0.026,69880,POINT (-87.746791 41.946682),60641-20210215
60641,02/16/2021,153,8133,93,6279,0.09,60,1854,0.027,69880,POINT (-87.746791 41.946682),60641-20210216
60641,02/17/2021,273,8406,146,6425,0.092,127,1981,0.028,69880,POINT (-87.746791 41.946682),60641-20210217
60641,02/18/2021,318,8724,161,6586,0.094,157,2138,0.031,69880,POINT (-87.746791 41.946682),60641-20210218
60642,12/27/2020,0,523,0,523,0.027,0,0,0,19716,POINT (-87.657821 41.899935),60642-20201227
60642,01/19/2021,63,1758,29,1183,0.06,34,575,0.029,19716,POINT (-87.657821 41.899935),60642-20210119
60642,01/21/2021,97,1954,74,1304,0.066,23,650,0.033,19716,POINT (-87.657821 41.899935),60642-20210121
60642,01/22/2021,78,2032,68,1372,0.07,10,660,0.033,19716,POINT (-87.657821 41.899935),60642-20210122
60642,01/23/2021,42,2074,38,1410,0.072,4,664,0.034,19716,POINT (-87.657821 41.899935),60642-20210123
60642,01/24/2021,22,2096,21,1431,0.073,1,665,0.034,19716,POINT (-87.657821 41.899935),60642-20210124
60642,01/25/2021,77,2173,46,1477,0.075,31,696,0.035,19716,POINT (-87.657821 41.899935),60642-20210125
60642,01/26/2021,93,2266,44,1521,0.077,49,745,0.038,19716,POINT (-87.657821 41.899935),60642-20210126
60642,01/27/2021,88,2354,56,1577,0.08,32,777,0.039,19716,POINT (-87.657821 41.899935),60642-20210127
60642,01/28/2021,104,2458,81,1658,0.084,23,800,0.041,19716,POINT (-87.657821 41.899935),60642-20210128
60642,01/29/2021,108,2566,87,1745,0.089,21,821,0.042,19716,POINT (-87.657821 41.899935),60642-20210129
60642,01/30/2021,49,2615,28,1773,0.09,21,842,0.043,19716,POINT (-87.657821 41.899935),60642-20210130
60642,01/31/2021,12,2627,9,1782,0.09,3,845,0.043,19716,POINT (-87.657821 41.899935),60642-20210131
60642,02/01/2021,65,2692,51,1833,0.093,14,859,0.044,19716,POINT (-87.657821 41.899935),60642-20210201
60642,02/02/2021,103,2795,65,1898,0.096,38,897,0.045,19716,POINT (-87.657821 41.899935),60642-20210202
60642,02/03/2021,111,2906,78,1976,0.1,33,930,0.047,19716,POINT (-87.657821 41.899935),60642-20210203
60642,02/04/2021,118,3024,97,2073,0.105,21,951,0.048,19716,POINT (-87.657821 41.899935),60642-20210204
60642,02/05/2021,108,3132,72,2145,0.109,36,987,0.05,19716,POINT (-87.657821 41.899935),60642-20210205
60642,02/06/2021,79,3211,50,2195,0.111,29,1016,0.052,19716,POINT (-87.657821 41.899935),60642-20210206
60642,02/07/2021,24,3235,17,2212,0.112,7,1023,0.052,19716,POINT (-87.657821 41.899935),60642-20210207
60642,02/08/2021,85,3320,64,2276,0.115,21,1044,0.053,19716,POINT (-87.657821 41.899935),60642-20210208
60642,02/09/2021,91,3411,57,2333,0.118,34,1078,0.055,19716,POINT (-87.657821 41.899935),60642-20210209
60642,02/10/2021,102,3513,67,2400,0.122,35,1113,0.056,19716,POINT (-87.657821 41.899935),60642-20210210
60642,02/11/2021,120,3633,63,2463,0.125,57,1170,0.059,19716,POINT (-87.657821 41.899935),60642-20210211
60642,02/12/2021,105,3738,60,2523,0.128,45,1215,0.062,19716,POINT (-87.657821 41.899935),60642-20210212
60642,02/13/2021,97,3835,64,2587,0.131,33,1248,0.063,19716,POINT (-87.657821 41.899935),60642-20210213
60642,02/14/2021,15,3850,8,2595,0.132,7,1255,0.064,19716,POINT (-87.657821 41.899935),60642-20210214
60642,02/15/2021,46,3896,22,2617,0.133,24,1279,0.065,19716,POINT (-87.657821 41.899935),60642-20210215
60642,02/16/2021,56,3952,34,2651,0.134,22,1301,0.066,19716,POINT (-87.657821 41.899935),60642-20210216
60642,02/17/2021,97,4049,46,2697,0.137,51,1352,0.069,19716,POINT (-87.657821 41.899935),60642-20210217
60642,02/18/2021,87,4136,30,2727,0.138,57,1409,0.071,19716,POINT (-87.657821 41.899935),60642-20210218
60643,01/22/2021,199,2321,185,1914,0.039,14,407,0.008,48887,POINT (-87.662381 41.700445),60643-20210122
60643,01/23/2021,107,2428,103,2017,0.041,4,411,0.008,48887,POINT (-87.662381 41.700445),60643-20210123
60643,01/24/2021,31,2459,31,2048,0.042,0,411,0.008,48887,POINT (-87.662381 41.700445),60643-20210124
60643,01/25/2021,121,2580,94,2142,0.044,27,438,0.009,48887,POINT (-87.662381 41.700445),60643-20210125
60643,01/26/2021,161,2741,129,2271,0.046,32,470,0.01,48887,POINT (-87.662381 41.700445),60643-20210126
60643,01/27/2021,223,2964,202,2473,0.051,21,491,0.01,48887,POINT (-87.662381 41.700445),60643-20210127
60643,01/28/2021,246,3210,216,2689,0.055,30,521,0.011,48887,POINT (-87.662381 41.700445),60643-20210128
60643,01/29/2021,225,3435,202,2891,0.059,23,544,0.011,48887,POINT (-87.662381 41.700445),60643-20210129
60643,01/30/2021,133,3568,116,3007,0.062,17,561,0.011,48887,POINT (-87.662381 41.700445),60643-20210130
60643,01/31/2021,39,3607,34,3041,0.062,5,566,0.012,48887,POINT (-87.662381 41.700445),60643-20210131
60643,02/01/2021,109,3716,91,3132,0.064,18,584,0.012,48887,POINT (-87.662381 41.700445),60643-20210201
60643,02/02/2021,222,3938,175,3307,0.068,47,631,0.013,48887,POINT (-87.662381 41.700445),60643-20210202
60643,02/03/2021,362,4300,247,3554,0.073,115,746,0.015,48887,POINT (-87.662381 41.700445),60643-20210203
60643,02/04/2021,286,4586,259,3813,0.078,27,773,0.016,48887,POINT (-87.662381 41.700445),60643-20210204
60643,02/05/2021,293,4879,237,4050,0.083,56,829,0.017,48887,POINT (-87.662381 41.700445),60643-20210205
60643,02/06/2021,172,5051,150,4200,0.086,22,851,0.017,48887,POINT (-87.662381 41.700445),60643-20210206
60642,01/20/2021,99,1857,47,1230,0.062,52,627,0.032,19716,POINT (-87.657821 41.899935),60642-20210120
60643,02/07/2021,52,5103,49,4249,0.087,3,854,0.017,48887,POINT (-87.662381 41.700445),60643-20210207
60643,02/08/2021,227,5330,164,4413,0.09,63,917,0.019,48887,POINT (-87.662381 41.700445),60643-20210208
60643,02/09/2021,261,5591,177,4590,0.094,84,1001,0.02,48887,POINT (-87.662381 41.700445),60643-20210209
60643,02/10/2021,557,6148,205,4795,0.098,352,1353,0.028,48887,POINT (-87.662381 41.700445),60643-20210210
60643,02/11/2021,386,6534,227,5022,0.103,159,1512,0.031,48887,POINT (-87.662381 41.700445),60643-20210211
60643,02/12/2021,311,6845,189,5211,0.107,122,1634,0.033,48887,POINT (-87.662381 41.700445),60643-20210212
60643,02/13/2021,319,7164,208,5419,0.111,111,1745,0.036,48887,POINT (-87.662381 41.700445),60643-20210213
60643,02/14/2021,51,7215,40,5459,0.112,11,1756,0.036,48887,POINT (-87.662381 41.700445),60643-20210214
60643,02/15/2021,110,7325,66,5525,0.113,44,1800,0.037,48887,POINT (-87.662381 41.700445),60643-20210215
60643,02/16/2021,113,7438,66,5591,0.114,47,1847,0.038,48887,POINT (-87.662381 41.700445),60643-20210216
60643,02/17/2021,251,7689,104,5695,0.116,147,1994,0.041,48887,POINT (-87.662381 41.700445),60643-20210217
60643,02/18/2021,308,7997,123,5818,0.119,185,2179,0.045,48887,POINT (-87.662381 41.700445),60643-20210218
60644,01/22/2021,81,1213,78,1088,0.023,3,125,0.003,46591,POINT (-87.756863 41.881113),60644-20210122
60644,01/23/2021,33,1246,31,1119,0.024,2,127,0.003,46591,POINT (-87.756863 41.881113),60644-20210123
60644,01/24/2021,3,1249,3,1122,0.024,0,127,0.003,46591,POINT (-87.756863 41.881113),60644-20210124
60644,01/25/2021,127,1376,72,1194,0.026,55,182,0.004,46591,POINT (-87.756863 41.881113),60644-20210125
60644,01/26/2021,61,1437,49,1243,0.027,12,194,0.004,46591,POINT (-87.756863 41.881113),60644-20210126
60644,01/27/2021,83,1520,70,1313,0.028,13,207,0.004,46591,POINT (-87.756863 41.881113),60644-20210127
60644,01/28/2021,89,1609,78,1391,0.03,11,218,0.005,46591,POINT (-87.756863 41.881113),60644-20210128
60644,01/29/2021,104,1713,92,1483,0.032,12,230,0.005,46591,POINT (-87.756863 41.881113),60644-20210129
60644,01/30/2021,162,1875,91,1574,0.034,71,301,0.006,46591,POINT (-87.756863 41.881113),60644-20210130
60644,01/31/2021,10,1885,9,1583,0.034,1,302,0.006,46591,POINT (-87.756863 41.881113),60644-20210131
60644,02/01/2021,72,1957,55,1638,0.035,17,319,0.007,46591,POINT (-87.756863 41.881113),60644-20210201
60644,02/02/2021,410,2367,223,1861,0.04,187,506,0.011,46591,POINT (-87.756863 41.881113),60644-20210202
60644,02/03/2021,142,2509,124,1985,0.043,18,524,0.011,46591,POINT (-87.756863 41.881113),60644-20210203
60644,02/04/2021,175,2684,165,2150,0.046,10,534,0.011,46591,POINT (-87.756863 41.881113),60644-20210204
60644,02/05/2021,153,2837,144,2294,0.049,9,543,0.012,46591,POINT (-87.756863 41.881113),60644-20210205
60644,02/06/2021,63,2900,52,2346,0.05,11,554,0.012,46591,POINT (-87.756863 41.881113),60644-20210206
60644,02/07/2021,6,2906,5,2351,0.05,1,555,0.012,46591,POINT (-87.756863 41.881113),60644-20210207
60644,02/08/2021,81,2987,74,2425,0.052,7,562,0.012,46591,POINT (-87.756863 41.881113),60644-20210208
60644,02/09/2021,126,3113,103,2528,0.054,23,585,0.013,46591,POINT (-87.756863 41.881113),60644-20210209
60644,02/10/2021,269,3382,156,2684,0.058,113,698,0.015,46591,POINT (-87.756863 41.881113),60644-20210210
60644,02/11/2021,169,3551,110,2794,0.06,59,757,0.016,46591,POINT (-87.756863 41.881113),60644-20210211
60644,02/12/2021,159,3710,103,2897,0.062,56,813,0.017,46591,POINT (-87.756863 41.881113),60644-20210212
60644,02/13/2021,100,3810,70,2967,0.064,30,843,0.018,46591,POINT (-87.756863 41.881113),60644-20210213
60644,02/14/2021,14,3824,13,2980,0.064,1,844,0.018,46591,POINT (-87.756863 41.881113),60644-20210214
60644,02/15/2021,62,3886,53,3033,0.065,9,853,0.018,46591,POINT (-87.756863 41.881113),60644-20210215
60644,02/16/2021,35,3921,27,3060,0.066,8,861,0.018,46591,POINT (-87.756863 41.881113),60644-20210216
60644,02/17/2021,99,4020,54,3114,0.067,45,906,0.019,46591,POINT (-87.756863 41.881113),60644-20210217
60644,02/18/2021,122,4142,75,3189,0.068,47,953,0.02,46591,POINT (-87.756863 41.881113),60644-20210218
60645,01/22/2021,116,2395,107,1999,0.042,9,396,0.008,47270,POINT (-87.695049 42.008927),60645-20210122
60645,01/23/2021,65,2460,56,2055,0.043,9,405,0.009,47270,POINT (-87.695049 42.008927),60645-20210123
60645,01/24/2021,23,2483,21,2076,0.044,2,407,0.009,47270,POINT (-87.695049 42.008927),60645-20210124
60645,01/25/2021,219,2702,163,2239,0.047,56,463,0.01,47270,POINT (-87.695049 42.008927),60645-20210125
60645,01/26/2021,487,3189,370,2609,0.055,117,580,0.012,47270,POINT (-87.695049 42.008927),60645-20210126
60645,01/27/2021,284,3473,157,2766,0.059,127,707,0.015,47270,POINT (-87.695049 42.008927),60645-20210127
60645,01/28/2021,171,3644,144,2910,0.062,27,734,0.016,47270,POINT (-87.695049 42.008927),60645-20210128
60645,01/29/2021,169,3813,141,3051,0.065,28,762,0.016,47270,POINT (-87.695049 42.008927),60645-20210129
60645,01/30/2021,88,3901,73,3124,0.066,15,777,0.016,47270,POINT (-87.695049 42.008927),60645-20210130
60645,01/31/2021,46,3947,37,3161,0.067,9,786,0.017,47270,POINT (-87.695049 42.008927),60645-20210131
60645,02/01/2021,228,4175,101,3262,0.069,127,913,0.019,47270,POINT (-87.695049 42.008927),60645-20210201
60645,02/02/2021,212,4387,132,3394,0.072,80,993,0.021,47270,POINT (-87.695049 42.008927),60645-20210202
60645,02/03/2021,222,4609,173,3567,0.075,49,1042,0.022,47270,POINT (-87.695049 42.008927),60645-20210203
60645,02/04/2021,342,4951,300,3867,0.082,42,1084,0.023,47270,POINT (-87.695049 42.008927),60645-20210204
60645,02/05/2021,262,5213,197,4064,0.086,65,1149,0.024,47270,POINT (-87.695049 42.008927),60645-20210205
60645,02/06/2021,105,5318,89,4153,0.088,16,1165,0.025,47270,POINT (-87.695049 42.008927),60645-20210206
60645,02/07/2021,104,5422,95,4248,0.09,9,1174,0.025,47270,POINT (-87.695049 42.008927),60645-20210207
60645,02/08/2021,140,5562,110,4358,0.092,30,1204,0.025,47270,POINT (-87.695049 42.008927),60645-20210208
60645,02/09/2021,231,5793,193,4551,0.096,38,1242,0.026,47270,POINT (-87.695049 42.008927),60645-20210209
60645,02/10/2021,258,6051,168,4719,0.1,90,1332,0.028,47270,POINT (-87.695049 42.008927),60645-20210210
60645,02/11/2021,329,6380,191,4910,0.104,138,1470,0.031,47270,POINT (-87.695049 42.008927),60645-20210211
60645,02/12/2021,287,6667,211,5121,0.108,76,1546,0.033,47270,POINT (-87.695049 42.008927),60645-20210212
60645,02/13/2021,184,6851,132,5253,0.111,52,1598,0.034,47270,POINT (-87.695049 42.008927),60645-20210213
60645,02/14/2021,97,6948,81,5334,0.113,16,1614,0.034,47270,POINT (-87.695049 42.008927),60645-20210214
60645,02/15/2021,161,7109,119,5453,0.115,42,1656,0.035,47270,POINT (-87.695049 42.008927),60645-20210215
60645,02/16/2021,185,7294,154,5607,0.119,31,1687,0.036,47270,POINT (-87.695049 42.008927),60645-20210216
60645,02/17/2021,256,7550,139,5746,0.122,117,1804,0.038,47270,POINT (-87.695049 42.008927),60645-20210217
60645,02/18/2021,330,7880,212,5958,0.126,118,1922,0.041,47270,POINT (-87.695049 42.008927),60645-20210218
60646,01/23/2021,179,2019,170,1604,0.056,9,415,0.015,28569,POINT (-87.761826 41.993931),60646-20210123
60646,01/24/2021,28,2047,26,1630,0.057,2,417,0.015,28569,POINT (-87.761826 41.993931),60646-20210124
60646,01/25/2021,105,2152,79,1709,0.06,26,443,0.016,28569,POINT (-87.761826 41.993931),60646-20210125
60646,01/26/2021,115,2267,83,1792,0.063,32,475,0.017,28569,POINT (-87.761826 41.993931),60646-20210126
60646,01/27/2021,140,2407,115,1907,0.067,25,500,0.018,28569,POINT (-87.761826 41.993931),60646-20210127
60646,01/28/2021,167,2574,147,2054,0.072,20,520,0.018,28569,POINT (-87.761826 41.993931),60646-20210128
60646,01/29/2021,123,2697,109,2163,0.076,14,534,0.019,28569,POINT (-87.761826 41.993931),60646-20210129
60646,01/30/2021,80,2777,71,2234,0.078,9,543,0.019,28569,POINT (-87.761826 41.993931),60646-20210130
60646,01/31/2021,25,2802,22,2256,0.079,3,546,0.019,28569,POINT (-87.761826 41.993931),60646-20210131
60646,02/01/2021,114,2916,84,2340,0.082,30,576,0.02,28569,POINT (-87.761826 41.993931),60646-20210201
60646,02/02/2021,176,3092,122,2462,0.086,54,630,0.022,28569,POINT (-87.761826 41.993931),60646-20210202
60646,02/03/2021,185,3277,144,2606,0.091,41,671,0.023,28569,POINT (-87.761826 41.993931),60646-20210203
60646,02/04/2021,212,3489,171,2777,0.097,41,712,0.025,28569,POINT (-87.761826 41.993931),60646-20210204
60646,02/05/2021,239,3728,195,2972,0.104,44,756,0.026,28569,POINT (-87.761826 41.993931),60646-20210205
60646,02/06/2021,114,3842,91,3063,0.107,23,779,0.027,28569,POINT (-87.761826 41.993931),60646-20210206
60646,02/07/2021,48,3890,42,3105,0.109,6,785,0.027,28569,POINT (-87.761826 41.993931),60646-20210207
60646,02/08/2021,137,4027,108,3213,0.112,29,814,0.028,28569,POINT (-87.761826 41.993931),60646-20210208
60646,02/09/2021,159,4186,131,3344,0.117,28,842,0.029,28569,POINT (-87.761826 41.993931),60646-20210209
60646,02/10/2021,370,4556,222,3566,0.125,148,990,0.035,28569,POINT (-87.761826 41.993931),60646-20210210
60646,02/11/2021,251,4807,163,3729,0.131,88,1078,0.038,28569,POINT (-87.761826 41.993931),60646-20210211
60646,02/12/2021,241,5048,173,3902,0.137,68,1146,0.04,28569,POINT (-87.761826 41.993931),60646-20210212
60646,02/13/2021,147,5195,103,4005,0.14,44,1190,0.042,28569,POINT (-87.761826 41.993931),60646-20210213
60646,02/14/2021,68,5263,54,4059,0.142,14,1204,0.042,28569,POINT (-87.761826 41.993931),60646-20210214
60646,02/15/2021,98,5361,66,4125,0.144,32,1236,0.043,28569,POINT (-87.761826 41.993931),60646-20210215
60646,02/16/2021,112,5473,66,4191,0.147,46,1282,0.045,28569,POINT (-87.761826 41.993931),60646-20210216
60646,02/17/2021,185,5658,106,4297,0.15,79,1361,0.048,28569,POINT (-87.761826 41.993931),60646-20210217
60646,02/18/2021,261,5919,101,4398,0.154,160,1521,0.053,28569,POINT (-87.761826 41.993931),60646-20210218
60647,01/20/2021,275,4464,182,3300,0.038,93,1164,0.013,87633,POINT (-87.701101 41.921058),60647-20210120
60647,01/21/2021,374,4838,318,3618,0.041,56,1220,0.014,87633,POINT (-87.701101 41.921058),60647-20210121
60647,01/22/2021,293,5131,276,3894,0.044,17,1237,0.014,87633,POINT (-87.701101 41.921058),60647-20210122
60647,01/23/2021,131,5262,118,4012,0.046,13,1250,0.014,87633,POINT (-87.701101 41.921058),60647-20210123
60647,01/24/2021,58,5320,55,4067,0.046,3,1253,0.014,87633,POINT (-87.701101 41.921058),60647-20210124
60647,01/25/2021,187,5507,142,4209,0.048,45,1298,0.015,87633,POINT (-87.701101 41.921058),60647-20210125
60647,01/26/2021,253,5760,172,4381,0.05,81,1379,0.016,87633,POINT (-87.701101 41.921058),60647-20210126
60647,01/27/2021,312,6072,253,4634,0.053,59,1438,0.016,87633,POINT (-87.701101 41.921058),60647-20210127
60647,01/28/2021,381,6453,314,4948,0.056,67,1505,0.017,87633,POINT (-87.701101 41.921058),60647-20210128
60647,01/29/2021,327,6780,285,5233,0.06,42,1547,0.018,87633,POINT (-87.701101 41.921058),60647-20210129
60647,01/30/2021,188,6968,143,5376,0.061,45,1592,0.018,87633,POINT (-87.701101 41.921058),60647-20210130
60647,01/31/2021,71,7039,56,5432,0.062,15,1607,0.018,87633,POINT (-87.701101 41.921058),60647-20210131
60647,02/01/2021,214,7253,165,5597,0.064,49,1656,0.019,87633,POINT (-87.701101 41.921058),60647-20210201
60647,02/02/2021,353,7606,238,5835,0.067,115,1771,0.02,87633,POINT (-87.701101 41.921058),60647-20210202
60647,02/03/2021,385,7991,314,6149,0.07,71,1842,0.021,87633,POINT (-87.701101 41.921058),60647-20210203
60647,02/04/2021,412,8403,322,6471,0.074,90,1932,0.022,87633,POINT (-87.701101 41.921058),60647-20210204
60647,02/05/2021,429,8832,326,6797,0.078,103,2035,0.023,87633,POINT (-87.701101 41.921058),60647-20210205
60647,02/06/2021,293,9125,205,7002,0.08,88,2123,0.024,87633,POINT (-87.701101 41.921058),60647-20210206
60647,02/07/2021,65,9190,49,7051,0.08,16,2139,0.024,87633,POINT (-87.701101 41.921058),60647-20210207
60647,02/08/2021,267,9457,196,7247,0.083,71,2210,0.025,87633,POINT (-87.701101 41.921058),60647-20210208
60647,02/09/2021,364,9821,251,7498,0.086,113,2323,0.027,87633,POINT (-87.701101 41.921058),60647-20210209
60647,02/10/2021,663,10484,396,7894,0.09,267,2590,0.03,87633,POINT (-87.701101 41.921058),60647-20210210
60647,02/11/2021,758,11242,316,8210,0.094,442,3032,0.035,87633,POINT (-87.701101 41.921058),60647-20210211
60647,02/12/2021,521,11763,316,8526,0.097,205,3237,0.037,87633,POINT (-87.701101 41.921058),60647-20210212
60647,02/13/2021,299,12062,206,8732,0.1,93,3330,0.038,87633,POINT (-87.701101 41.921058),60647-20210213
60647,02/14/2021,78,12140,58,8790,0.1,20,3350,0.038,87633,POINT (-87.701101 41.921058),60647-20210214
60647,02/15/2021,221,12361,148,8938,0.102,73,3423,0.039,87633,POINT (-87.701101 41.921058),60647-20210215
60647,02/16/2021,191,12552,122,9060,0.103,69,3492,0.04,87633,POINT (-87.701101 41.921058),60647-20210216
60647,02/17/2021,360,12912,186,9246,0.106,174,3666,0.042,87633,POINT (-87.701101 41.921058),60647-20210217
60647,02/18/2021,353,13265,162,9408,0.107,191,3857,0.044,87633,POINT (-87.701101 41.921058),60647-20210218
60646,12/19/2020,53,156,53,156,0.005,0,0,0,28569,POINT (-87.761826 41.993931),60646-20201219
60646,12/20/2020,14,170,14,170,0.006,0,0,0,28569,POINT (-87.761826 41.993931),60646-20201220
60646,12/21/2020,55,225,55,225,0.008,0,0,0,28569,POINT (-87.761826 41.993931),60646-20201221
60646,12/22/2020,30,255,30,255,0.009,0,0,0,28569,POINT (-87.761826 41.993931),60646-20201222
60646,12/23/2020,49,304,49,304,0.011,0,0,0,28569,POINT (-87.761826 41.993931),60646-20201223
60646,12/24/2020,5,309,5,309,0.011,0,0,0,28569,POINT (-87.761826 41.993931),60646-20201224
60646,12/25/2020,0,309,0,309,0.011,0,0,0,28569,POINT (-87.761826 41.993931),60646-20201225
60646,12/26/2020,8,317,8,317,0.011,0,0,0,28569,POINT (-87.761826 41.993931),60646-20201226
60646,12/27/2020,0,317,0,317,0.011,0,0,0,28569,POINT (-87.761826 41.993931),60646-20201227
60646,12/28/2020,18,335,18,335,0.012,0,0,0,28569,POINT (-87.761826 41.993931),60646-20201228
60646,12/29/2020,47,382,47,382,0.013,0,0,0,28569,POINT (-87.761826 41.993931),60646-20201229
60646,12/30/2020,43,425,43,425,0.015,0,0,0,28569,POINT (-87.761826 41.993931),60646-20201230
60646,12/31/2020,35,460,35,460,0.016,0,0,0,28569,POINT (-87.761826 41.993931),60646-20201231
60646,01/01/2021,1,461,1,461,0.016,0,0,0,28569,POINT (-87.761826 41.993931),60646-20210101
60646,01/02/2021,11,472,11,472,0.017,0,0,0,28569,POINT (-87.761826 41.993931),60646-20210102
60646,01/04/2021,52,529,52,529,0.019,0,0,0,28569,POINT (-87.761826 41.993931),60646-20210104
60646,01/05/2021,62,591,62,591,0.021,0,0,0,28569,POINT (-87.761826 41.993931),60646-20210105
60646,01/06/2021,33,624,27,618,0.022,6,6,0,28569,POINT (-87.761826 41.993931),60646-20210106
60646,01/07/2021,72,696,33,651,0.023,39,45,0.002,28569,POINT (-87.761826 41.993931),60646-20210107
60646,01/08/2021,98,794,22,673,0.024,76,121,0.004,28569,POINT (-87.761826 41.993931),60646-20210108
60646,01/09/2021,52,846,10,683,0.024,42,163,0.006,28569,POINT (-87.761826 41.993931),60646-20210109
60646,01/10/2021,10,856,6,689,0.024,4,167,0.006,28569,POINT (-87.761826 41.993931),60646-20210110
60649,01/22/2021,161,1669,152,1487,0.032,9,182,0.004,46633,POINT (-87.571522 41.762202),60649-20210122
60649,01/23/2021,60,1729,52,1539,0.033,8,190,0.004,46633,POINT (-87.571522 41.762202),60649-20210123
60649,01/24/2021,35,1764,34,1573,0.034,1,191,0.004,46633,POINT (-87.571522 41.762202),60649-20210124
60649,01/25/2021,102,1866,91,1664,0.036,11,202,0.004,46633,POINT (-87.571522 41.762202),60649-20210125
60649,01/26/2021,209,2075,126,1790,0.038,83,285,0.006,46633,POINT (-87.571522 41.762202),60649-20210126
60649,01/27/2021,119,2194,100,1890,0.041,19,304,0.007,46633,POINT (-87.571522 41.762202),60649-20210127
60649,01/28/2021,132,2326,119,2009,0.043,13,317,0.007,46633,POINT (-87.571522 41.762202),60649-20210128
60649,01/29/2021,162,2488,142,2151,0.046,20,337,0.007,46633,POINT (-87.571522 41.762202),60649-20210129
60649,01/30/2021,57,2545,52,2203,0.047,5,342,0.007,46633,POINT (-87.571522 41.762202),60649-20210130
60649,01/31/2021,11,2556,11,2214,0.047,0,342,0.007,46633,POINT (-87.571522 41.762202),60649-20210131
60649,02/01/2021,92,2648,78,2292,0.049,14,356,0.008,46633,POINT (-87.571522 41.762202),60649-20210201
60649,02/02/2021,95,2743,66,2358,0.051,29,385,0.008,46633,POINT (-87.571522 41.762202),60649-20210202
60649,02/03/2021,142,2885,115,2473,0.053,27,412,0.009,46633,POINT (-87.571522 41.762202),60649-20210203
60649,02/04/2021,184,3069,152,2625,0.056,32,444,0.01,46633,POINT (-87.571522 41.762202),60649-20210204
60649,02/05/2021,248,3317,116,2741,0.059,132,576,0.012,46633,POINT (-87.571522 41.762202),60649-20210205
60649,02/06/2021,91,3408,63,2804,0.06,28,604,0.013,46633,POINT (-87.571522 41.762202),60649-20210206
60647,01/04/2021,81,1489,75,1483,0.017,6,6,0,87633,POINT (-87.701101 41.921058),60647-20210104
60647,01/05/2021,116,1605,107,1590,0.018,9,15,0,87633,POINT (-87.701101 41.921058),60647-20210105
60647,01/06/2021,103,1708,75,1665,0.019,28,43,0,87633,POINT (-87.701101 41.921058),60647-20210106
60647,01/07/2021,207,1915,80,1745,0.02,127,170,0.002,87633,POINT (-87.701101 41.921058),60647-20210107
60649,02/07/2021,21,3429,17,2821,0.06,4,608,0.013,46633,POINT (-87.571522 41.762202),60649-20210207
60649,02/08/2021,206,3635,97,2918,0.063,109,717,0.015,46633,POINT (-87.571522 41.762202),60649-20210208
60649,02/09/2021,160,3795,88,3006,0.064,72,789,0.017,46633,POINT (-87.571522 41.762202),60649-20210209
60649,02/10/2021,285,4080,154,3160,0.068,131,920,0.02,46633,POINT (-87.571522 41.762202),60649-20210210
60649,02/11/2021,248,4328,128,3288,0.071,120,1040,0.022,46633,POINT (-87.571522 41.762202),60649-20210211
60649,02/12/2021,184,4512,80,3368,0.072,104,1144,0.025,46633,POINT (-87.571522 41.762202),60649-20210212
60649,02/13/2021,123,4635,79,3447,0.074,44,1188,0.025,46633,POINT (-87.571522 41.762202),60649-20210213
60649,02/14/2021,25,4660,23,3470,0.074,2,1190,0.026,46633,POINT (-87.571522 41.762202),60649-20210214
60649,02/15/2021,124,4784,66,3536,0.076,58,1248,0.027,46633,POINT (-87.571522 41.762202),60649-20210215
60649,02/16/2021,76,4860,30,3566,0.076,46,1294,0.028,46633,POINT (-87.571522 41.762202),60649-20210216
60649,02/17/2021,158,5018,71,3637,0.078,87,1381,0.03,46633,POINT (-87.571522 41.762202),60649-20210217
60649,02/18/2021,185,5203,78,3715,0.08,107,1488,0.032,46633,POINT (-87.571522 41.762202),60649-20210218
60651,01/21/2021,131,1048,121,862,0.014,10,186,0.003,63492,POINT (-87.741017 41.901964),60651-20210121
60651,01/22/2021,118,1166,115,977,0.015,3,189,0.003,63492,POINT (-87.741017 41.901964),60651-20210122
60651,01/23/2021,48,1214,45,1022,0.016,3,192,0.003,63492,POINT (-87.741017 41.901964),60651-20210123
60651,01/24/2021,7,1221,6,1028,0.016,1,193,0.003,63492,POINT (-87.741017 41.901964),60651-20210124
60651,01/25/2021,82,1303,59,1087,0.017,23,216,0.003,63492,POINT (-87.741017 41.901964),60651-20210125
60647,12/18/2020,242,337,242,337,0.004,0,0,0,87633,POINT (-87.701101 41.921058),60647-20201218
60647,12/19/2020,160,497,160,497,0.006,0,0,0,87633,POINT (-87.701101 41.921058),60647-20201219
60647,12/20/2020,37,534,37,534,0.006,0,0,0,87633,POINT (-87.701101 41.921058),60647-20201220
60647,12/21/2020,146,680,146,680,0.008,0,0,0,87633,POINT (-87.701101 41.921058),60647-20201221
60647,12/22/2020,151,831,151,831,0.009,0,0,0,87633,POINT (-87.701101 41.921058),60647-20201222
60647,12/23/2020,103,934,103,934,0.011,0,0,0,87633,POINT (-87.701101 41.921058),60647-20201223
60647,12/24/2020,36,970,36,970,0.011,0,0,0,87633,POINT (-87.701101 41.921058),60647-20201224
60647,12/25/2020,0,970,0,970,0.011,0,0,0,87633,POINT (-87.701101 41.921058),60647-20201225
60647,12/26/2020,13,983,13,983,0.011,0,0,0,87633,POINT (-87.701101 41.921058),60647-20201226
60647,12/27/2020,0,983,0,983,0.011,0,0,0,87633,POINT (-87.701101 41.921058),60647-20201227
60647,12/28/2020,58,1041,58,1041,0.012,0,0,0,87633,POINT (-87.701101 41.921058),60647-20201228
60647,12/29/2020,118,1159,118,1159,0.013,0,0,0,87633,POINT (-87.701101 41.921058),60647-20201229
60647,12/30/2020,124,1283,124,1283,0.015,0,0,0,87633,POINT (-87.701101 41.921058),60647-20201230
60647,12/31/2020,60,1343,60,1343,0.015,0,0,0,87633,POINT (-87.701101 41.921058),60647-20201231
60647,01/01/2021,0,1343,0,1343,0.015,0,0,0,87633,POINT (-87.701101 41.921058),60647-20210101
60647,01/02/2021,45,1388,45,1388,0.016,0,0,0,87633,POINT (-87.701101 41.921058),60647-20210102
60647,01/03/2021,20,1408,20,1408,0.016,0,0,0,87633,POINT (-87.701101 41.921058),60647-20210103
60647,01/08/2021,294,2209,84,1829,0.021,210,380,0.004,87633,POINT (-87.701101 41.921058),60647-20210108
60647,01/09/2021,174,2383,50,1879,0.021,124,504,0.006,87633,POINT (-87.701101 41.921058),60647-20210109
60647,01/10/2021,47,2430,23,1902,0.022,24,528,0.006,87633,POINT (-87.701101 41.921058),60647-20210110
60647,01/11/2021,186,2616,54,1956,0.022,132,660,0.008,87633,POINT (-87.701101 41.921058),60647-20210111
60647,01/12/2021,244,2860,133,2089,0.024,111,771,0.009,87633,POINT (-87.701101 41.921058),60647-20210112
60647,01/13/2021,417,3277,315,2404,0.027,102,873,0.01,87633,POINT (-87.701101 41.921058),60647-20210113
60647,01/14/2021,275,3552,241,2645,0.03,34,907,0.01,87633,POINT (-87.701101 41.921058),60647-20210114
60647,01/15/2021,156,3708,136,2781,0.032,20,927,0.011,87633,POINT (-87.701101 41.921058),60647-20210115
60647,01/16/2021,116,3824,107,2888,0.033,9,936,0.011,87633,POINT (-87.701101 41.921058),60647-20210116
60647,01/17/2021,33,3857,24,2912,0.033,9,945,0.011,87633,POINT (-87.701101 41.921058),60647-20210117
60647,01/18/2021,135,3992,92,3004,0.034,43,988,0.011,87633,POINT (-87.701101 41.921058),60647-20210118
60647,01/19/2021,197,4189,114,3118,0.036,83,1071,0.012,87633,POINT (-87.701101 41.921058),60647-20210119
60651,01/26/2021,101,1404,79,1166,0.018,22,238,0.004,63492,POINT (-87.741017 41.901964),60651-20210126
60651,01/27/2021,128,1532,115,1281,0.02,13,251,0.004,63492,POINT (-87.741017 41.901964),60651-20210127
60651,01/28/2021,149,1681,124,1405,0.022,25,276,0.004,63492,POINT (-87.741017 41.901964),60651-20210128
60651,01/29/2021,185,1866,169,1574,0.025,16,292,0.005,63492,POINT (-87.741017 41.901964),60651-20210129
60651,01/30/2021,68,1934,56,1630,0.026,12,304,0.005,63492,POINT (-87.741017 41.901964),60651-20210130
60651,01/31/2021,12,1946,11,1641,0.026,1,305,0.005,63492,POINT (-87.741017 41.901964),60651-20210131
60651,02/01/2021,93,2039,78,1719,0.027,15,320,0.005,63492,POINT (-87.741017 41.901964),60651-20210201
60651,02/02/2021,370,2409,308,2027,0.032,62,382,0.006,63492,POINT (-87.741017 41.901964),60651-20210202
60651,02/03/2021,182,2591,155,2182,0.034,27,409,0.006,63492,POINT (-87.741017 41.901964),60651-20210203
60651,02/04/2021,220,2811,199,2381,0.038,21,430,0.007,63492,POINT (-87.741017 41.901964),60651-20210204
60651,02/05/2021,192,3003,164,2545,0.04,28,458,0.007,63492,POINT (-87.741017 41.901964),60651-20210205
60651,02/06/2021,123,3126,100,2645,0.042,23,481,0.008,63492,POINT (-87.741017 41.901964),60651-20210206
60651,02/07/2021,22,3148,17,2662,0.042,5,486,0.008,63492,POINT (-87.741017 41.901964),60651-20210207
60651,02/08/2021,128,3276,107,2769,0.044,21,507,0.008,63492,POINT (-87.741017 41.901964),60651-20210208
60651,02/09/2021,144,3420,111,2880,0.045,33,540,0.009,63492,POINT (-87.741017 41.901964),60651-20210209
60651,02/10/2021,179,3599,132,3012,0.047,47,587,0.009,63492,POINT (-87.741017 41.901964),60651-20210210
60651,02/11/2021,276,3875,191,3203,0.05,85,672,0.011,63492,POINT (-87.741017 41.901964),60651-20210211
60651,01/04/2021,29,280,27,278,0.004,2,2,0,63492,POINT (-87.741017 41.901964),60651-20210104
60651,01/05/2021,62,342,62,340,0.005,0,2,0,63492,POINT (-87.741017 41.901964),60651-20210105
60651,01/06/2021,28,370,25,365,0.006,3,5,0,63492,POINT (-87.741017 41.901964),60651-20210106
60651,01/07/2021,29,399,23,388,0.006,6,11,0,63492,POINT (-87.741017 41.901964),60651-20210107
60651,01/08/2021,60,459,33,421,0.007,27,38,0.001,63492,POINT (-87.741017 41.901964),60651-20210108
60651,01/09/2021,17,476,11,432,0.007,6,44,0.001,63492,POINT (-87.741017 41.901964),60651-20210109
60651,01/10/2021,9,485,6,438,0.007,3,47,0.001,63492,POINT (-87.741017 41.901964),60651-20210110
60651,01/11/2021,34,519,21,459,0.007,13,60,0.001,63492,POINT (-87.741017 41.901964),60651-20210111
60651,01/12/2021,58,577,42,501,0.008,16,76,0.001,63492,POINT (-87.741017 41.901964),60651-20210112
60651,01/13/2021,46,623,29,530,0.008,17,93,0.001,63492,POINT (-87.741017 41.901964),60651-20210113
60651,01/14/2021,39,662,36,566,0.009,3,96,0.002,63492,POINT (-87.741017 41.901964),60651-20210114
60651,01/15/2021,43,705,39,605,0.01,4,100,0.002,63492,POINT (-87.741017 41.901964),60651-20210115
60651,01/16/2021,27,732,24,629,0.01,3,103,0.002,63492,POINT (-87.741017 41.901964),60651-20210116
60651,02/12/2021,278,4153,195,3398,0.054,83,755,0.012,63492,POINT (-87.741017 41.901964),60651-20210212
60651,02/13/2021,159,4312,125,3523,0.055,34,789,0.012,63492,POINT (-87.741017 41.901964),60651-20210213
60651,02/14/2021,23,4335,20,3543,0.056,3,792,0.012,63492,POINT (-87.741017 41.901964),60651-20210214
60651,02/15/2021,151,4486,117,3660,0.058,34,826,0.013,63492,POINT (-87.741017 41.901964),60651-20210215
60651,02/16/2021,74,4560,46,3706,0.058,28,854,0.013,63492,POINT (-87.741017 41.901964),60651-20210216
60651,02/17/2021,156,4716,91,3797,0.06,65,919,0.014,63492,POINT (-87.741017 41.901964),60651-20210217
60651,02/18/2021,172,4888,89,3886,0.061,83,1002,0.016,63492,POINT (-87.741017 41.901964),60651-20210218
60652,02/05/2021,188,2791,178,2203,0.051,10,588,0.014,43447,POINT (-87.714238 41.745398),60652-20210205
60652,02/06/2021,82,2873,73,2276,0.052,9,597,0.014,43447,POINT (-87.714238 41.745398),60652-20210206
60652,02/07/2021,30,2903,28,2304,0.053,2,599,0.014,43447,POINT (-87.714238 41.745398),60652-20210207
60652,02/08/2021,126,3029,107,2411,0.055,19,618,0.014,43447,POINT (-87.714238 41.745398),60652-20210208
60652,02/09/2021,157,3186,126,2537,0.058,31,649,0.015,43447,POINT (-87.714238 41.745398),60652-20210209
60652,02/10/2021,185,3371,147,2684,0.062,38,687,0.016,43447,POINT (-87.714238 41.745398),60652-20210210
60652,02/11/2021,211,3582,162,2846,0.066,49,736,0.017,43447,POINT (-87.714238 41.745398),60652-20210211
60652,02/12/2021,165,3747,127,2973,0.068,38,774,0.018,43447,POINT (-87.714238 41.745398),60652-20210212
60651,01/17/2021,4,736,4,633,0.01,0,103,0.002,63492,POINT (-87.741017 41.901964),60651-20210117
60651,01/18/2021,42,778,23,656,0.01,19,122,0.002,63492,POINT (-87.741017 41.901964),60651-20210118
60651,01/19/2021,40,818,22,678,0.011,18,140,0.002,63492,POINT (-87.741017 41.901964),60651-20210119
60652,02/13/2021,139,3886,104,3077,0.071,35,809,0.019,43447,POINT (-87.714238 41.745398),60652-20210213
60652,02/14/2021,43,3929,35,3112,0.072,8,817,0.019,43447,POINT (-87.714238 41.745398),60652-20210214
60652,02/15/2021,127,4056,118,3230,0.074,9,826,0.019,43447,POINT (-87.714238 41.745398),60652-20210215
60652,02/16/2021,82,4138,65,3295,0.076,17,843,0.019,43447,POINT (-87.714238 41.745398),60652-20210216
60652,02/17/2021,172,4310,100,3395,0.078,72,915,0.021,43447,POINT (-87.714238 41.745398),60652-20210217
60652,02/18/2021,183,4493,108,3503,0.081,75,990,0.023,43447,POINT (-87.714238 41.745398),60652-20210218
60653,01/27/2021,214,1823,121,1439,0.043,93,384,0.012,33154,POINT (-87.611244 41.819261),60653-20210127
60653,01/28/2021,115,1938,103,1542,0.047,12,396,0.012,33154,POINT (-87.611244 41.819261),60653-20210128
60653,01/30/2021,51,2171,43,1754,0.053,8,417,0.013,33154,POINT (-87.611244 41.819261),60653-20210130
60653,01/31/2021,8,2179,7,1761,0.053,1,418,0.013,33154,POINT (-87.611244 41.819261),60653-20210131
60653,02/01/2021,61,2240,48,1809,0.055,13,431,0.013,33154,POINT (-87.611244 41.819261),60653-20210201
60653,02/02/2021,106,2346,74,1883,0.057,32,463,0.014,33154,POINT (-87.611244 41.819261),60653-20210202
60653,02/03/2021,108,2454,91,1974,0.06,17,480,0.014,33154,POINT (-87.611244 41.819261),60653-20210203
60653,02/04/2021,185,2639,165,2139,0.065,20,500,0.015,33154,POINT (-87.611244 41.819261),60653-20210204
60653,02/05/2021,115,2754,92,2231,0.067,23,523,0.016,33154,POINT (-87.611244 41.819261),60653-20210205
60653,02/06/2021,159,2913,91,2322,0.07,68,591,0.018,33154,POINT (-87.611244 41.819261),60653-20210206
60653,02/07/2021,16,2929,15,2337,0.07,1,592,0.018,33154,POINT (-87.611244 41.819261),60653-20210207
60653,02/08/2021,97,3026,69,2406,0.073,28,620,0.019,33154,POINT (-87.611244 41.819261),60653-20210208
60653,02/09/2021,146,3172,91,2497,0.075,55,675,0.02,33154,POINT (-87.611244 41.819261),60653-20210209
60653,02/10/2021,130,3302,103,2600,0.078,27,702,0.021,33154,POINT (-87.611244 41.819261),60653-20210210
60653,02/11/2021,274,3576,147,2747,0.083,127,829,0.025,33154,POINT (-87.611244 41.819261),60653-20210211
60653,02/12/2021,136,3712,67,2814,0.085,69,898,0.027,33154,POINT (-87.611244 41.819261),60653-20210212
60653,02/13/2021,144,3856,99,2913,0.088,45,943,0.028,33154,POINT (-87.611244 41.819261),60653-20210213
60653,02/14/2021,28,3884,27,2940,0.089,1,944,0.028,33154,POINT (-87.611244 41.819261),60653-20210214
60652,01/27/2021,132,1651,112,1260,0.029,20,391,0.009,43447,POINT (-87.714238 41.745398),60652-20210127
60652,01/28/2021,131,1782,104,1364,0.031,27,418,0.01,43447,POINT (-87.714238 41.745398),60652-20210128
60652,01/29/2021,134,1916,110,1474,0.034,24,442,0.01,43447,POINT (-87.714238 41.745398),60652-20210129
60653,02/15/2021,73,3957,42,2982,0.09,31,975,0.029,33154,POINT (-87.611244 41.819261),60653-20210215
60653,02/16/2021,97,4054,67,3049,0.092,30,1005,0.03,33154,POINT (-87.611244 41.819261),60653-20210216
60653,02/17/2021,127,4181,55,3104,0.094,72,1077,0.032,33154,POINT (-87.611244 41.819261),60653-20210217
60653,02/18/2021,121,4302,48,3152,0.095,73,1150,0.035,33154,POINT (-87.611244 41.819261),60653-20210218
60654,01/22/2021,97,1950,81,1295,0.065,16,655,0.033,20022,POINT (-87.636354 41.892485),60654-20210122
60654,01/23/2021,49,1999,44,1339,0.067,5,660,0.033,20022,POINT (-87.636354 41.892485),60654-20210123
60654,01/26/2021,84,2180,42,1463,0.073,42,717,0.036,20022,POINT (-87.636354 41.892485),60654-20210126
60654,01/27/2021,69,2249,53,1516,0.076,16,733,0.037,20022,POINT (-87.636354 41.892485),60654-20210127
60654,01/28/2021,115,2364,79,1595,0.08,36,769,0.038,20022,POINT (-87.636354 41.892485),60654-20210128
60654,01/29/2021,86,2450,75,1670,0.083,11,780,0.039,20022,POINT (-87.636354 41.892485),60654-20210129
60654,01/30/2021,52,2502,40,1710,0.085,12,792,0.04,20022,POINT (-87.636354 41.892485),60654-20210130
60654,01/31/2021,30,2532,26,1736,0.087,4,796,0.04,20022,POINT (-87.636354 41.892485),60654-20210131
60654,02/01/2021,50,2582,39,1775,0.089,11,807,0.04,20022,POINT (-87.636354 41.892485),60654-20210201
60654,02/02/2021,113,2695,71,1846,0.092,42,849,0.042,20022,POINT (-87.636354 41.892485),60654-20210202
60654,02/03/2021,77,2772,53,1899,0.095,24,873,0.044,20022,POINT (-87.636354 41.892485),60654-20210203
60654,02/04/2021,98,2870,81,1980,0.099,17,890,0.044,20022,POINT (-87.636354 41.892485),60654-20210204
60654,02/05/2021,125,2995,107,2087,0.104,18,908,0.045,20022,POINT (-87.636354 41.892485),60654-20210205
60654,02/06/2021,53,3048,35,2122,0.106,18,926,0.046,20022,POINT (-87.636354 41.892485),60654-20210206
60654,02/07/2021,27,3075,21,2143,0.107,6,932,0.047,20022,POINT (-87.636354 41.892485),60654-20210207
60654,02/08/2021,86,3161,60,2203,0.11,26,958,0.048,20022,POINT (-87.636354 41.892485),60654-20210208
60654,02/14/2021,30,3805,24,2616,0.131,6,1189,0.059,20022,POINT (-87.636354 41.892485),60654-20210214
60654,02/15/2021,35,3840,21,2637,0.132,14,1203,0.06,20022,POINT (-87.636354 41.892485),60654-20210215
60654,02/16/2021,86,3926,70,2707,0.135,16,1219,0.061,20022,POINT (-87.636354 41.892485),60654-20210216
60654,02/17/2021,84,4010,41,2748,0.137,43,1262,0.063,20022,POINT (-87.636354 41.892485),60654-20210217
60654,02/18/2021,97,4107,35,2783,0.139,62,1324,0.066,20022,POINT (-87.636354 41.892485),60654-20210218
60655,01/26/2021,134,2302,102,1806,0.063,32,496,0.017,28569,POINT (-87.701434 41.696456),60655-20210126
60655,01/30/2021,237,3170,123,2468,0.086,114,702,0.025,28569,POINT (-87.701434 41.696456),60655-20210130
60655,01/31/2021,26,3196,24,2492,0.087,2,704,0.025,28569,POINT (-87.701434 41.696456),60655-20210131
60655,02/01/2021,122,3318,82,2574,0.09,40,744,0.026,28569,POINT (-87.701434 41.696456),60655-20210201
60655,02/02/2021,214,3532,149,2723,0.095,65,809,0.028,28569,POINT (-87.701434 41.696456),60655-20210202
60655,02/03/2021,189,3721,164,2887,0.101,25,834,0.029,28569,POINT (-87.701434 41.696456),60655-20210203
60655,02/04/2021,216,3937,191,3078,0.108,25,859,0.03,28569,POINT (-87.701434 41.696456),60655-20210204
60655,02/05/2021,196,4133,172,3250,0.114,24,883,0.031,28569,POINT (-87.701434 41.696456),60655-20210205
60655,02/06/2021,97,4230,81,3331,0.117,16,899,0.031,28569,POINT (-87.701434 41.696456),60655-20210206
60655,02/07/2021,32,4262,28,3359,0.118,4,903,0.032,28569,POINT (-87.701434 41.696456),60655-20210207
60655,02/08/2021,134,4396,98,3457,0.121,36,939,0.033,28569,POINT (-87.701434 41.696456),60655-20210208
60655,02/09/2021,198,4594,138,3595,0.126,60,999,0.035,28569,POINT (-87.701434 41.696456),60655-20210209
60655,02/10/2021,274,4868,149,3744,0.131,125,1124,0.039,28569,POINT (-87.701434 41.696456),60655-20210210
60655,02/11/2021,299,5167,188,3932,0.138,111,1235,0.043,28569,POINT (-87.701434 41.696456),60655-20210211
60654,12/15/2020,0,0,0,0,0,0,0,0,20022,POINT (-87.636354 41.892485),60654-20201215
60654,12/16/2020,5,5,5,5,0,0,0,0,20022,POINT (-87.636354 41.892485),60654-20201216
60654,12/17/2020,69,74,69,74,0.004,0,0,0,20022,POINT (-87.636354 41.892485),60654-20201217
60654,12/18/2020,136,210,136,210,0.01,0,0,0,20022,POINT (-87.636354 41.892485),60654-20201218
60654,12/19/2020,81,291,81,291,0.015,0,0,0,20022,POINT (-87.636354 41.892485),60654-20201219
60654,12/20/2020,14,305,14,305,0.015,0,0,0,20022,POINT (-87.636354 41.892485),60654-20201220
60654,12/21/2020,95,400,95,400,0.02,0,0,0,20022,POINT (-87.636354 41.892485),60654-20201221
60654,12/22/2020,82,482,82,482,0.024,0,0,0,20022,POINT (-87.636354 41.892485),60654-20201222
60654,12/23/2020,36,518,36,518,0.026,0,0,0,20022,POINT (-87.636354 41.892485),60654-20201223
60654,12/24/2020,10,528,10,528,0.026,0,0,0,20022,POINT (-87.636354 41.892485),60654-20201224
60654,12/25/2020,0,528,0,528,0.026,0,0,0,20022,POINT (-87.636354 41.892485),60654-20201225
60654,12/26/2020,17,545,17,545,0.027,0,0,0,20022,POINT (-87.636354 41.892485),60654-20201226
60654,12/27/2020,0,545,0,545,0.027,0,0,0,20022,POINT (-87.636354 41.892485),60654-20201227
60654,12/28/2020,27,572,27,572,0.029,0,0,0,20022,POINT (-87.636354 41.892485),60654-20201228
60654,12/29/2020,48,620,48,620,0.031,0,0,0,20022,POINT (-87.636354 41.892485),60654-20201229
60654,12/30/2020,33,653,33,653,0.033,0,0,0,20022,POINT (-87.636354 41.892485),60654-20201230
60654,12/31/2020,12,665,12,665,0.033,0,0,0,20022,POINT (-87.636354 41.892485),60654-20201231
60654,01/01/2021,1,666,1,666,0.033,0,0,0,20022,POINT (-87.636354 41.892485),60654-20210101
60654,01/02/2021,14,680,14,680,0.034,0,0,0,20022,POINT (-87.636354 41.892485),60654-20210102
60654,01/03/2021,9,689,9,689,0.034,0,0,0,20022,POINT (-87.636354 41.892485),60654-20210103
60654,01/04/2021,27,716,24,713,0.036,3,3,0,20022,POINT (-87.636354 41.892485),60654-20210104
60654,01/05/2021,47,763,40,753,0.038,7,10,0,20022,POINT (-87.636354 41.892485),60654-20210105
60654,01/06/2021,39,802,22,775,0.039,17,27,0.001,20022,POINT (-87.636354 41.892485),60654-20210106
60654,01/07/2021,108,910,28,803,0.04,80,107,0.005,20022,POINT (-87.636354 41.892485),60654-20210107
60654,01/08/2021,151,1061,34,837,0.042,117,224,0.011,20022,POINT (-87.636354 41.892485),60654-20210108
60654,01/09/2021,79,1140,13,850,0.042,66,290,0.014,20022,POINT (-87.636354 41.892485),60654-20210109
60654,01/10/2021,19,1159,5,855,0.043,14,304,0.015,20022,POINT (-87.636354 41.892485),60654-20210110
60654,01/11/2021,108,1267,22,877,0.044,86,390,0.019,20022,POINT (-87.636354 41.892485),60654-20210111
60654,01/12/2021,117,1384,39,916,0.046,78,468,0.023,20022,POINT (-87.636354 41.892485),60654-20210112
60654,01/13/2021,71,1455,34,950,0.047,37,505,0.025,20022,POINT (-87.636354 41.892485),60654-20210113
60654,01/14/2021,33,1488,24,974,0.049,9,514,0.026,20022,POINT (-87.636354 41.892485),60654-20210114
60654,01/15/2021,44,1532,36,1010,0.05,8,522,0.026,20022,POINT (-87.636354 41.892485),60654-20210115
60654,01/16/2021,33,1565,24,1034,0.052,9,531,0.027,20022,POINT (-87.636354 41.892485),60654-20210116
60654,01/17/2021,19,1584,8,1042,0.052,11,542,0.027,20022,POINT (-87.636354 41.892485),60654-20210117
60654,01/18/2021,46,1630,25,1067,0.053,21,563,0.028,20022,POINT (-87.636354 41.892485),60654-20210118
60654,01/19/2021,69,1699,29,1096,0.055,40,603,0.03,20022,POINT (-87.636354 41.892485),60654-20210119
60654,01/20/2021,61,1760,41,1137,0.057,20,623,0.031,20022,POINT (-87.636354 41.892485),60654-20210120
60655,02/12/2021,236,5403,153,4085,0.143,83,1318,0.046,28569,POINT (-87.701434 41.696456),60655-20210212
60655,02/13/2021,130,5533,94,4179,0.146,36,1354,0.047,28569,POINT (-87.701434 41.696456),60655-20210213
60655,02/14/2021,29,5562,17,4196,0.147,12,1366,0.048,28569,POINT (-87.701434 41.696456),60655-20210214
60655,02/15/2021,84,5646,59,4255,0.149,25,1391,0.049,28569,POINT (-87.701434 41.696456),60655-20210215
60655,02/16/2021,85,5731,51,4306,0.151,34,1425,0.05,28569,POINT (-87.701434 41.696456),60655-20210216
60655,02/17/2021,245,5976,81,4387,0.154,164,1589,0.056,28569,POINT (-87.701434 41.696456),60655-20210217
60655,02/18/2021,270,6246,86,4473,0.157,184,1773,0.062,28569,POINT (-87.701434 41.696456),60655-20210218
60656,02/06/2021,100,2206,90,1746,0.062,10,460,0.016,28218,POINT (-87.817934 41.974566),60656-20210206
60656,02/08/2021,96,2331,70,1844,0.065,26,487,0.017,28218,POINT (-87.817934 41.974566),60656-20210208
60656,02/12/2021,151,2935,124,2331,0.083,27,604,0.021,28218,POINT (-87.817934 41.974566),60656-20210212
60656,02/13/2021,120,3055,88,2419,0.086,32,636,0.023,28218,POINT (-87.817934 41.974566),60656-20210213
60656,02/14/2021,38,3093,33,2452,0.087,5,641,0.023,28218,POINT (-87.817934 41.974566),60656-20210214
60656,02/15/2021,82,3175,65,2517,0.089,17,658,0.023,28218,POINT (-87.817934 41.974566),60656-20210215
60656,02/16/2021,74,3249,55,2572,0.091,19,677,0.024,28218,POINT (-87.817934 41.974566),60656-20210216
60656,02/17/2021,138,3387,77,2649,0.094,61,738,0.026,28218,POINT (-87.817934 41.974566),60656-20210217
60656,02/18/2021,142,3529,62,2711,0.096,80,818,0.029,28218,POINT (-87.817934 41.974566),60656-20210218
60657,01/13/2021,237,4754,124,3412,0.048,113,1342,0.019,70958,POINT (-87.658216 41.939715),60657-20210113
60657,01/19/2021,232,6058,103,4344,0.061,129,1714,0.024,70958,POINT (-87.658216 41.939715),60657-20210119
60657,01/20/2021,332,6390,177,4521,0.064,155,1869,0.026,70958,POINT (-87.658216 41.939715),60657-20210120
60657,01/21/2021,361,6751,288,4809,0.068,73,1942,0.027,70958,POINT (-87.658216 41.939715),60657-20210121
60657,01/22/2021,342,7093,298,5107,0.072,44,1986,0.028,70958,POINT (-87.658216 41.939715),60657-20210122
60657,01/23/2021,179,7272,156,5263,0.074,23,2009,0.028,70958,POINT (-87.658216 41.939715),60657-20210123
60657,01/25/2021,260,7600,191,5512,0.078,69,2088,0.029,70958,POINT (-87.658216 41.939715),60657-20210125
60657,01/26/2021,343,7943,190,5702,0.08,153,2241,0.032,70958,POINT (-87.658216 41.939715),60657-20210126
60657,01/27/2021,300,8243,204,5906,0.083,96,2337,0.033,70958,POINT (-87.658216 41.939715),60657-20210127
60657,01/28/2021,385,8628,304,6210,0.088,81,2418,0.034,70958,POINT (-87.658216 41.939715),60657-20210128
60657,01/29/2021,372,9000,331,6541,0.092,41,2459,0.035,70958,POINT (-87.658216 41.939715),60657-20210129
60657,01/30/2021,176,9176,126,6667,0.094,50,2509,0.035,70958,POINT (-87.658216 41.939715),60657-20210130
60657,01/31/2021,70,9246,57,6724,0.095,13,2522,0.036,70958,POINT (-87.658216 41.939715),60657-20210131
60657,02/01/2021,270,9516,153,6877,0.097,117,2639,0.037,70958,POINT (-87.658216 41.939715),60657-20210201
60657,02/02/2021,388,9904,234,7111,0.1,154,2793,0.039,70958,POINT (-87.658216 41.939715),60657-20210202
60657,02/03/2021,356,10260,260,7371,0.104,96,2889,0.041,70958,POINT (-87.658216 41.939715),60657-20210203
60657,02/04/2021,404,10664,324,7695,0.108,80,2969,0.042,70958,POINT (-87.658216 41.939715),60657-20210204
60657,02/05/2021,517,11181,392,8087,0.114,125,3094,0.044,70958,POINT (-87.658216 41.939715),60657-20210205
60657,02/06/2021,266,11447,174,8261,0.116,92,3186,0.045,70958,POINT (-87.658216 41.939715),60657-20210206
60657,02/07/2021,355,11802,247,8508,0.12,108,3294,0.046,70958,POINT (-87.658216 41.939715),60657-20210207
60657,02/08/2021,249,12051,175,8683,0.122,74,3368,0.047,70958,POINT (-87.658216 41.939715),60657-20210208
60657,02/09/2021,333,12384,191,8874,0.125,142,3510,0.049,70958,POINT (-87.658216 41.939715),60657-20210209
60657,02/10/2021,447,12831,312,9186,0.129,135,3645,0.051,70958,POINT (-87.658216 41.939715),60657-20210210
60657,02/13/2021,365,14220,210,9930,0.14,155,4290,0.06,70958,POINT (-87.658216 41.939715),60657-20210213
60657,02/14/2021,314,14534,79,10009,0.141,235,4525,0.064,70958,POINT (-87.658216 41.939715),60657-20210214
60657,02/15/2021,238,14772,94,10103,0.142,144,4669,0.066,70958,POINT (-87.658216 41.939715),60657-20210215
60657,02/16/2021,237,15009,160,10263,0.145,77,4746,0.067,70958,POINT (-87.658216 41.939715),60657-20210216
60657,02/17/2021,300,15309,135,10398,0.147,165,4911,0.069,70958,POINT (-87.658216 41.939715),60657-20210217
60657,02/18/2021,387,15696,160,10558,0.149,227,5138,0.072,70958,POINT (-87.658216 41.939715),60657-20210218
60659,01/20/2021,99,1710,68,1392,0.033,31,318,0.007,42735,POINT (-87.703266 41.990803),60659-20210120
60659,01/21/2021,126,1836,100,1492,0.035,26,344,0.008,42735,POINT (-87.703266 41.990803),60659-20210121
60659,01/22/2021,106,1942,99,1591,0.037,7,351,0.008,42735,POINT (-87.703266 41.990803),60659-20210122
60659,01/23/2021,49,1991,43,1634,0.038,6,357,0.008,42735,POINT (-87.703266 41.990803),60659-20210123
60659,01/24/2021,19,2010,14,1648,0.039,5,362,0.008,42735,POINT (-87.703266 41.990803),60659-20210124
60659,01/25/2021,91,2101,58,1706,0.04,33,395,0.009,42735,POINT (-87.703266 41.990803),60659-20210125
60659,01/26/2021,114,2215,69,1775,0.042,45,440,0.01,42735,POINT (-87.703266 41.990803),60659-20210126
60659,01/27/2021,165,2380,104,1879,0.044,61,501,0.012,42735,POINT (-87.703266 41.990803),60659-20210127
60659,01/28/2021,115,2495,98,1977,0.046,17,518,0.012,42735,POINT (-87.703266 41.990803),60659-20210128
60659,02/03/2021,136,3110,101,2447,0.057,35,663,0.016,42735,POINT (-87.703266 41.990803),60659-20210203
60659,02/04/2021,246,3356,200,2647,0.062,46,709,0.017,42735,POINT (-87.703266 41.990803),60659-20210204
60659,02/05/2021,220,3576,156,2803,0.066,64,773,0.018,42735,POINT (-87.703266 41.990803),60659-20210205
60659,02/06/2021,90,3666,79,2882,0.067,11,784,0.018,42735,POINT (-87.703266 41.990803),60659-20210206
60659,02/07/2021,57,3723,55,2937,0.069,2,786,0.018,42735,POINT (-87.703266 41.990803),60659-20210207
60659,02/08/2021,123,3846,96,3033,0.071,27,813,0.019,42735,POINT (-87.703266 41.990803),60659-20210208
60659,02/09/2021,148,3994,110,3143,0.074,38,851,0.02,42735,POINT (-87.703266 41.990803),60659-20210209
60659,02/10/2021,241,4235,164,3307,0.077,77,928,0.022,42735,POINT (-87.703266 41.990803),60659-20210210
60659,02/11/2021,383,4618,182,3489,0.082,201,1129,0.026,42735,POINT (-87.703266 41.990803),60659-20210211
60659,02/12/2021,233,4851,147,3636,0.085,86,1215,0.028,42735,POINT (-87.703266 41.990803),60659-20210212
60659,02/13/2021,150,5001,89,3725,0.087,61,1276,0.03,42735,POINT (-87.703266 41.990803),60659-20210213
60659,02/14/2021,43,5044,34,3759,0.088,9,1285,0.03,42735,POINT (-87.703266 41.990803),60659-20210214
60659,02/15/2021,134,5178,113,3872,0.091,21,1306,0.031,42735,POINT (-87.703266 41.990803),60659-20210215
60659,02/16/2021,77,5255,60,3932,0.092,17,1323,0.031,42735,POINT (-87.703266 41.990803),60659-20210216
60659,02/17/2021,171,5426,105,4037,0.094,66,1389,0.033,42735,POINT (-87.703266 41.990803),60659-20210217
60659,02/18/2021,173,5599,112,4149,0.097,61,1450,0.034,42735,POINT (-87.703266 41.990803),60659-20210218
60660,01/09/2021,59,1786,26,1598,0.036,33,188,0.004,44498,POINT (-87.666362 41.991062),60660-20210109
60660,01/20/2021,112,2607,85,2168,0.049,27,439,0.01,44498,POINT (-87.666362 41.991062),60660-20210120
60660,01/21/2021,191,2798,159,2327,0.052,32,471,0.011,44498,POINT (-87.666362 41.991062),60660-20210121
60660,01/22/2021,155,2953,132,2459,0.055,23,494,0.011,44498,POINT (-87.666362 41.991062),60660-20210122
60660,01/23/2021,86,3039,74,2533,0.057,12,506,0.011,44498,POINT (-87.666362 41.991062),60660-20210123
60660,01/24/2021,22,3061,21,2554,0.057,1,507,0.011,44498,POINT (-87.666362 41.991062),60660-20210124
60660,01/25/2021,142,3203,100,2654,0.06,42,549,0.012,44498,POINT (-87.666362 41.991062),60660-20210125
60660,01/26/2021,145,3348,95,2749,0.062,50,599,0.013,44498,POINT (-87.666362 41.991062),60660-20210126
60660,01/27/2021,249,3597,161,2910,0.065,88,687,0.015,44498,POINT (-87.666362 41.991062),60660-20210127
60660,01/28/2021,204,3801,159,3069,0.069,45,732,0.016,44498,POINT (-87.666362 41.991062),60660-20210128
60660,01/29/2021,182,3983,163,3232,0.073,19,751,0.017,44498,POINT (-87.666362 41.991062),60660-20210129
60660,01/30/2021,98,4081,87,3319,0.075,11,762,0.017,44498,POINT (-87.666362 41.991062),60660-20210130
60660,02/04/2021,584,5288,262,3972,0.089,322,1316,0.03,44498,POINT (-87.666362 41.991062),60660-20210204
60660,02/05/2021,516,5804,258,4230,0.095,258,1574,0.035,44498,POINT (-87.666362 41.991062),60660-20210205
60660,02/06/2021,133,5937,92,4322,0.097,41,1615,0.036,44498,POINT (-87.666362 41.991062),60660-20210206
60660,02/07/2021,48,5985,38,4360,0.098,10,1625,0.037,44498,POINT (-87.666362 41.991062),60660-20210207
60660,02/08/2021,151,6136,110,4470,0.1,41,1666,0.037,44498,POINT (-87.666362 41.991062),60660-20210208
60659,12/15/2020,0,0,0,0,0,0,0,0,42735,POINT (-87.703266 41.990803),60659-20201215
60659,12/16/2020,2,2,2,2,0,0,0,0,42735,POINT (-87.703266 41.990803),60659-20201216
60659,12/17/2020,14,16,14,16,0,0,0,0,42735,POINT (-87.703266 41.990803),60659-20201217
60659,12/18/2020,44,60,44,60,0.001,0,0,0,42735,POINT (-87.703266 41.990803),60659-20201218
60659,12/19/2020,32,92,32,92,0.002,0,0,0,42735,POINT (-87.703266 41.990803),60659-20201219
60659,12/20/2020,7,99,7,99,0.002,0,0,0,42735,POINT (-87.703266 41.990803),60659-20201220
60659,12/21/2020,61,160,61,160,0.004,0,0,0,42735,POINT (-87.703266 41.990803),60659-20201221
60659,12/22/2020,36,196,36,196,0.005,0,0,0,42735,POINT (-87.703266 41.990803),60659-20201222
60659,12/23/2020,41,237,41,237,0.006,0,0,0,42735,POINT (-87.703266 41.990803),60659-20201223
60659,12/24/2020,9,246,9,246,0.006,0,0,0,42735,POINT (-87.703266 41.990803),60659-20201224
60659,12/25/2020,0,246,0,246,0.006,0,0,0,42735,POINT (-87.703266 41.990803),60659-20201225
60659,12/26/2020,4,250,4,250,0.006,0,0,0,42735,POINT (-87.703266 41.990803),60659-20201226
60659,12/27/2020,2,252,2,252,0.006,0,0,0,42735,POINT (-87.703266 41.990803),60659-20201227
60659,12/28/2020,27,279,27,279,0.007,0,0,0,42735,POINT (-87.703266 41.990803),60659-20201228
60659,12/29/2020,58,337,58,337,0.008,0,0,0,42735,POINT (-87.703266 41.990803),60659-20201229
60659,12/30/2020,45,382,45,382,0.009,0,0,0,42735,POINT (-87.703266 41.990803),60659-20201230
60659,12/31/2020,32,414,32,414,0.01,0,0,0,42735,POINT (-87.703266 41.990803),60659-20201231
60659,01/01/2021,0,414,0,414,0.01,0,0,0,42735,POINT (-87.703266 41.990803),60659-20210101
60659,01/02/2021,12,426,12,426,0.01,0,0,0,42735,POINT (-87.703266 41.990803),60659-20210102
60659,01/03/2021,23,449,23,449,0.011,0,0,0,42735,POINT (-87.703266 41.990803),60659-20210103
60659,01/04/2021,71,520,71,520,0.012,0,0,0,42735,POINT (-87.703266 41.990803),60659-20210104
60659,01/05/2021,66,586,65,585,0.014,1,1,0,42735,POINT (-87.703266 41.990803),60659-20210105
60659,01/06/2021,67,653,58,643,0.015,9,10,0,42735,POINT (-87.703266 41.990803),60659-20210106
60659,01/07/2021,99,752,61,704,0.016,38,48,0.001,42735,POINT (-87.703266 41.990803),60659-20210107
60659,01/08/2021,72,824,42,746,0.017,30,78,0.002,42735,POINT (-87.703266 41.990803),60659-20210108
60659,01/09/2021,38,862,15,761,0.018,23,101,0.002,42735,POINT (-87.703266 41.990803),60659-20210109
60659,01/10/2021,11,873,3,764,0.018,8,109,0.003,42735,POINT (-87.703266 41.990803),60659-20210110
60659,01/11/2021,66,939,22,786,0.018,44,153,0.004,42735,POINT (-87.703266 41.990803),60659-20210111
60659,01/12/2021,74,1013,45,831,0.019,29,182,0.004,42735,POINT (-87.703266 41.990803),60659-20210112
60659,01/13/2021,100,1113,61,892,0.021,39,221,0.005,42735,POINT (-87.703266 41.990803),60659-20210113
60659,01/14/2021,175,1288,168,1060,0.025,7,228,0.005,42735,POINT (-87.703266 41.990803),60659-20210114
60659,01/15/2021,68,1356,63,1123,0.026,5,233,0.005,42735,POINT (-87.703266 41.990803),60659-20210115
60659,01/16/2021,110,1466,108,1231,0.029,2,235,0.005,42735,POINT (-87.703266 41.990803),60659-20210116
60659,01/17/2021,6,1472,6,1237,0.029,0,235,0.005,42735,POINT (-87.703266 41.990803),60659-20210117
60659,01/18/2021,53,1525,37,1274,0.03,16,251,0.006,42735,POINT (-87.703266 41.990803),60659-20210118
60660,02/09/2021,163,6299,119,4589,0.103,44,1710,0.038,44498,POINT (-87.666362 41.991062),60660-20210209
60660,02/10/2021,327,6626,233,4822,0.108,94,1804,0.041,44498,POINT (-87.666362 41.991062),60660-20210210
60660,02/13/2021,205,7410,147,5325,0.12,58,2085,0.047,44498,POINT (-87.666362 41.991062),60660-20210213
60660,02/14/2021,50,7460,27,5352,0.12,23,2108,0.047,44498,POINT (-87.666362 41.991062),60660-20210214
60660,02/15/2021,132,7592,101,5453,0.123,31,2139,0.048,44498,POINT (-87.666362 41.991062),60660-20210215
60660,02/16/2021,126,7718,99,5552,0.125,27,2166,0.049,44498,POINT (-87.666362 41.991062),60660-20210216
60660,02/17/2021,195,7913,101,5653,0.127,94,2260,0.051,44498,POINT (-87.666362 41.991062),60660-20210217
60660,02/18/2021,241,8154,110,5763,0.13,131,2391,0.054,44498,POINT (-87.666362 41.991062),60660-20210218
60661,01/22/2021,35,1260,33,831,0.08,2,429,0.041,10354,POINT (-87.644283 41.882786),60661-20210122
60661,01/23/2021,19,1279,15,846,0.082,4,433,0.042,10354,POINT (-87.644283 41.882786),60661-20210123
60661,01/24/2021,8,1287,3,849,0.082,5,438,0.042,10354,POINT (-87.644283 41.882786),60661-20210124
60661,01/25/2021,35,1322,8,857,0.083,27,465,0.045,10354,POINT (-87.644283 41.882786),60661-20210125
60661,01/26/2021,44,1366,27,884,0.085,17,482,0.047,10354,POINT (-87.644283 41.882786),60661-20210126
60661,01/27/2021,43,1409,29,913,0.088,14,496,0.048,10354,POINT (-87.644283 41.882786),60661-20210127
60661,01/28/2021,65,1474,48,961,0.093,17,513,0.05,10354,POINT (-87.644283 41.882786),60661-20210128
60661,01/29/2021,41,1515,32,993,0.096,9,522,0.05,10354,POINT (-87.644283 41.882786),60661-20210129
60661,01/30/2021,15,1530,6,999,0.096,9,531,0.051,10354,POINT (-87.644283 41.882786),60661-20210130
60661,01/31/2021,5,1535,3,1002,0.097,2,533,0.051,10354,POINT (-87.644283 41.882786),60661-20210131
60661,02/04/2021,69,1725,47,1122,0.108,22,603,0.058,10354,POINT (-87.644283 41.882786),60661-20210204
60661,02/05/2021,74,1799,52,1174,0.113,22,625,0.06,10354,POINT (-87.644283 41.882786),60661-20210205
60661,02/06/2021,31,1830,18,1192,0.115,13,638,0.062,10354,POINT (-87.644283 41.882786),60661-20210206
60661,02/07/2021,15,1845,14,1206,0.116,1,639,0.062,10354,POINT (-87.644283 41.882786),60661-20210207
60661,02/09/2021,41,1905,25,1244,0.12,16,661,0.064,10354,POINT (-87.644283 41.882786),60661-20210209
60661,02/10/2021,59,1964,42,1286,0.124,17,678,0.065,10354,POINT (-87.644283 41.882786),60661-20210210
60661,02/11/2021,55,2019,23,1309,0.126,32,710,0.069,10354,POINT (-87.644283 41.882786),60661-20210211
60661,02/12/2021,56,2075,30,1339,0.129,26,736,0.071,10354,POINT (-87.644283 41.882786),60661-20210212
60661,02/15/2021,27,2158,19,1392,0.134,8,766,0.074,10354,POINT (-87.644283 41.882786),60661-20210215
60661,02/16/2021,43,2201,27,1419,0.137,16,782,0.076,10354,POINT (-87.644283 41.882786),60661-20210216
60661,02/17/2021,44,2245,22,1441,0.139,22,804,0.078,10354,POINT (-87.644283 41.882786),60661-20210217
60661,02/18/2021,51,2296,27,1468,0.142,24,828,0.08,10354,POINT (-87.644283 41.882786),60661-20210218
60707,01/22/2021,48,566,46,461,0.011,2,105,0.002,43093,POINT (-87.808283 41.921777),60707-20210122
60707,01/23/2021,28,594,28,489,0.011,0,105,0.002,43093,POINT (-87.808283 41.921777),60707-20210123
60707,01/24/2021,2,596,1,490,0.011,1,106,0.002,43093,POINT (-87.808283 41.921777),60707-20210124
60707,01/25/2021,12,608,9,499,0.012,3,109,0.003,43093,POINT (-87.808283 41.921777),60707-20210125
60707,01/26/2021,29,637,20,519,0.012,9,118,0.003,43093,POINT (-87.808283 41.921777),60707-20210126
60707,01/27/2021,48,685,38,557,0.013,10,128,0.003,43093,POINT (-87.808283 41.921777),60707-20210127
60707,01/28/2021,54,739,48,605,0.014,6,134,0.003,43093,POINT (-87.808283 41.921777),60707-20210128
60707,01/29/2021,48,787,43,648,0.015,5,139,0.003,43093,POINT (-87.808283 41.921777),60707-20210129
60707,01/30/2021,39,826,35,683,0.016,4,143,0.003,43093,POINT (-87.808283 41.921777),60707-20210130
60707,01/31/2021,8,834,7,690,0.016,1,144,0.003,43093,POINT (-87.808283 41.921777),60707-20210131
60707,02/01/2021,35,869,27,717,0.017,8,152,0.004,43093,POINT (-87.808283 41.921777),60707-20210201
60707,02/02/2021,67,936,46,763,0.018,21,173,0.004,43093,POINT (-87.808283 41.921777),60707-20210202
60707,02/03/2021,64,1000,53,816,0.019,11,184,0.004,43093,POINT (-87.808283 41.921777),60707-20210203
60707,02/04/2021,79,1079,72,888,0.021,7,191,0.004,43093,POINT (-87.808283 41.921777),60707-20210204
60707,02/05/2021,75,1154,54,942,0.022,21,212,0.005,43093,POINT (-87.808283 41.921777),60707-20210205
60707,02/06/2021,61,1215,49,991,0.023,12,224,0.005,43093,POINT (-87.808283 41.921777),60707-20210206
60707,02/07/2021,5,1220,4,995,0.023,1,225,0.005,43093,POINT (-87.808283 41.921777),60707-20210207
60707,02/08/2021,54,1274,50,1045,0.024,4,229,0.005,43093,POINT (-87.808283 41.921777),60707-20210208
60707,02/09/2021,67,1341,54,1099,0.026,13,242,0.006,43093,POINT (-87.808283 41.921777),60707-20210209
60707,02/10/2021,94,1435,77,1176,0.027,17,259,0.006,43093,POINT (-87.808283 41.921777),60707-20210210
60707,02/11/2021,93,1528,58,1234,0.029,35,294,0.007,43093,POINT (-87.808283 41.921777),60707-20210211
60707,02/12/2021,91,1619,51,1285,0.03,40,334,0.008,43093,POINT (-87.808283 41.921777),60707-20210212
60707,02/13/2021,83,1702,55,1340,0.031,28,362,0.008,43093,POINT (-87.808283 41.921777),60707-20210213
60707,02/14/2021,15,1717,14,1354,0.031,1,363,0.008,43093,POINT (-87.808283 41.921777),60707-20210214
60707,02/15/2021,23,1740,21,1375,0.032,2,365,0.008,43093,POINT (-87.808283 41.921777),60707-20210215
60707,02/16/2021,25,1765,20,1395,0.032,5,370,0.009,43093,POINT (-87.808283 41.921777),60707-20210216
60707,02/17/2021,56,1821,25,1420,0.033,31,401,0.009,43093,POINT (-87.808283 41.921777),60707-20210217
60707,02/18/2021,55,1876,22,1442,0.033,33,434,0.01,43093,POINT (-87.808283 41.921777),60707-20210218
60827,02/18/2021,6,163,1,122,0.004,5,41,0.001,28483,POINT (-87.633087 41.650765),60827-20210218
Unknown,02/18/2021,70,1721,13,1120,0,57,601,0,0,,Unknown-20210218
60601,02/19/2021,24,3102,12,2090,0.139,12,1012,0.067,15083,POINT (-87.622844 41.886262),60601-20210219
60606,02/19/2021,14,834,6,563,0.171,8,271,0.082,3287,POINT (-87.63676 41.882634),60606-20210219
60611,02/19/2021,81,13121,39,8244,0.248,42,4877,0.147,33224,POINT (-87.620291 41.894734),60611-20210219
60666,02/19/2021,0,25,0,23,0,0,2,0,0,POINT (-87.896371 41.979511),60666-20210219
60645,02/19/2021,134,8014,90,6048,0.128,44,1966,0.042,47270,POINT (-87.695049 42.008927),60645-20210219
60625,02/19/2021,199,11882,114,8680,0.109,85,3202,0.04,79444,POINT (-87.701816 41.971155),60625-20210219
60640,02/19/2021,195,14816,119,10447,0.151,76,4369,0.063,69363,POINT (-87.662232 41.971888),60640-20210219
60626,02/19/2021,121,8599,67,5877,0.116,54,2722,0.054,50544,POINT (-87.669834 42.009469),60626-20210219
60657,02/19/2021,161,15857,77,10635,0.15,84,5222,0.074,70958,POINT (-87.658216 41.939715),60657-20210219
60615,02/19/2021,84,9490,42,5947,0.147,42,3543,0.087,40590,POINT (-87.602725 41.801993),60615-20210219
60621,02/19/2021,102,1959,74,1502,0.054,28,457,0.016,28018,POINT (-87.638812 41.776931),60621-20210219
60651,02/19/2021,131,5019,82,3968,0.062,49,1051,0.017,63492,POINT (-87.741017 41.901964),60651-20210219
60707,02/19/2021,54,1930,27,1469,0.034,27,461,0.011,43093,POINT (-87.808283 41.921777),60707-20210219
60631,02/19/2021,118,6698,76,4971,0.168,42,1727,0.058,29529,POINT (-87.813371 41.995019),60631-20210219
60602,02/19/2021,6,520,5,358,0.313,1,162,0.141,1145,POINT (-87.628309 41.883136),60602-20210219
60607,02/19/2021,110,8075,54,5123,0.175,56,2952,0.101,29293,POINT (-87.652727 41.876104),60607-20210219
60630,02/19/2021,164,8173,89,6104,0.108,75,2069,0.037,56433,POINT (-87.759611 41.971261),60630-20210219
60641,02/19/2021,231,8955,137,6723,0.096,94,2232,0.032,69880,POINT (-87.746791 41.946682),60641-20210219
60622,02/19/2021,153,11668,76,7837,0.147,77,3831,0.072,53294,POINT (-87.681818 41.902762),60622-20210219
60636,02/19/2021,88,1996,54,1590,0.053,34,406,0.014,30024,POINT (-87.668597 41.77599),60636-20210219
60610,02/19/2021,115,8742,48,6005,0.148,67,2737,0.068,40548,POINT (-87.63581 41.90455),60610-20210219
60659,02/19/2021,81,5680,49,4198,0.098,32,1482,0.035,42735,POINT (-87.703266 41.990803),60659-20210219
60614,02/19/2021,183,14815,86,10065,0.14,97,4750,0.066,71954,POINT (-87.652064 41.922605),60614-20210219
60644,02/19/2021,90,4232,57,3246,0.07,33,986,0.021,46591,POINT (-87.756863 41.881113),60644-20210219
60603,02/19/2021,4,534,1,401,0.381,3,133,0.126,1052,POINT (-87.625473 41.880112),60603-20210219
60634,02/19/2021,193,10450,99,7721,0.103,94,2729,0.036,75082,POINT (-87.797373 41.944967),60634-20210219
60637,02/19/2021,65,6479,37,4187,0.089,28,2292,0.048,47300,POINT (-87.604053 41.780991),60637-20210219
60649,02/19/2021,99,5302,58,3773,0.081,41,1529,0.033,46633,POINT (-87.571522 41.762202),60649-20210219
60618,02/19/2021,276,14195,150,10263,0.108,126,3932,0.041,94907,POINT (-87.703343 41.946699),60618-20210219
60623,02/19/2021,161,7480,92,6038,0.074,69,1442,0.018,81283,POINT (-87.717446 41.850321),60623-20210219
60647,02/19/2021,238,13503,121,9529,0.109,117,3974,0.045,87633,POINT (-87.701101 41.921058),60647-20210219
Unknown,02/19/2021,46,1767,19,1139,0,27,628,0,0,,Unknown-20210219
60629,02/19/2021,360,10007,227,8098,0.074,133,1909,0.017,110029,POINT (-87.711565 41.777061),60629-20210219
60613,02/19/2021,153,10506,82,7209,0.142,71,3297,0.065,50761,POINT (-87.661343 41.953742),60613-20210219
60660,02/19/2021,149,8303,85,5848,0.131,64,2455,0.055,44498,POINT (-87.666362 41.991062),60660-20210219
60654,02/19/2021,44,4151,25,2808,0.14,19,1343,0.067,20022,POINT (-87.636354 41.892485),60654-20210219
60608,02/19/2021,259,11330,155,8415,0.105,104,2915,0.036,80059,POINT (-87.670366 41.849879),60608-20210219
60642,02/19/2021,62,4198,30,2757,0.14,32,1441,0.073,19716,POINT (-87.657821 41.899935),60642-20210219
60604,02/19/2021,3,326,3,255,0.31,0,71,0.086,823,POINT (-87.629029 41.878153),60604-20210219
60638,02/19/2021,245,7683,139,5882,0.1,106,1801,0.031,58669,POINT (-87.771902 41.787032),60638-20210219
60653,02/19/2021,91,4393,51,3203,0.097,40,1190,0.036,33154,POINT (-87.611244 41.819261),60653-20210219
60619,02/19/2021,202,6848,115,5023,0.082,87,1825,0.03,61207,POINT (-87.60569 41.744737),60619-20210219
60655,02/19/2021,168,6414,89,4562,0.16,79,1852,0.065,28569,POINT (-87.701434 41.696456),60655-20210219
60617,02/19/2021,227,8608,112,6403,0.077,115,2205,0.026,83553,POINT (-87.556897 41.721257),60617-20210219
60633,02/19/2021,28,1012,14,775,0.061,14,237,0.019,12689,POINT (-87.556037 41.653147),60633-20210219
60612,02/19/2021,120,6157,76,4157,0.123,44,2000,0.059,33735,POINT (-87.687011 41.88004),60612-20210219
60646,02/19/2021,111,6030,69,4467,0.156,42,1563,0.055,28569,POINT (-87.761826 41.993931),60646-20210219
60643,02/19/2021,226,8223,134,5952,0.122,92,2271,0.046,48887,POINT (-87.662381 41.700445),60643-20210219
60628,02/19/2021,212,5652,120,4268,0.066,92,1384,0.022,64254,POINT (-87.621537 41.694192),60628-20210219
60661,02/19/2021,24,2320,13,1481,0.143,11,839,0.081,10354,POINT (-87.644283 41.882786),60661-20210219
60624,02/19/2021,75,2570,44,2037,0.058,31,533,0.015,34892,POINT (-87.722735 41.879417),60624-20210219
60609,02/19/2021,153,5970,90,4566,0.075,63,1404,0.023,60939,POINT (-87.653382 41.812017),60609-20210219
60827,02/19/2021,7,170,2,124,0.004,5,46,0.002,28483,POINT (-87.633087 41.650765),60827-20210219
60639,02/19/2021,173,8663,90,6952,0.079,83,1711,0.019,88204,POINT (-87.75531 41.920609),60639-20210219
60632,02/19/2021,259,8770,169,7329,0.082,90,1441,0.016,89857,POINT (-87.711251 41.810038),60632-20210219
60656,02/19/2021,87,3616,48,2759,0.098,39,857,0.03,28218,POINT (-87.817934 41.974566),60656-20210219
60620,02/19/2021,207,5789,141,4473,0.066,66,1316,0.019,67711,POINT (-87.651656 41.740873),60620-20210219
60605,02/19/2021,111,8082,45,5151,0.177,66,2931,0.101,29060,POINT (-87.623449 41.867824),60605-20210219
Unknown,02/11/2021,91,1478,17,1027,0,74,451,0,0,,Unknown-20210211
60652,02/19/2021,145,4638,101,3604,0.083,44,1034,0.024,43447,POINT (-87.714238 41.745398),60652-20210219
60616,02/19/2021,183,9179,86,6513,0.12,97,2666,0.049,54197,POINT (-87.629531 41.844869),60616-20210219
60601,01/21/2021,98,1242,86,862,0.057,12,380,0.025,15083,POINT (-87.622844 41.886262),60601-20210121
60601,01/22/2021,119,1361,108,970,0.064,11,391,0.026,15083,POINT (-87.622844 41.886262),60601-20210122
60601,01/23/2021,30,1391,29,999,0.066,1,392,0.026,15083,POINT (-87.622844 41.886262),60601-20210123
60601,01/24/2021,10,1401,9,1008,0.067,1,393,0.026,15083,POINT (-87.622844 41.886262),60601-20210124
60601,01/25/2021,59,1460,36,1044,0.069,23,416,0.028,15083,POINT (-87.622844 41.886262),60601-20210125
60601,01/26/2021,64,1524,36,1080,0.072,28,444,0.029,15083,POINT (-87.622844 41.886262),60601-20210126
60601,01/27/2021,65,1589,51,1131,0.075,14,458,0.03,15083,POINT (-87.622844 41.886262),60601-20210127
60601,01/28/2021,88,1677,68,1199,0.079,20,478,0.032,15083,POINT (-87.622844 41.886262),60601-20210128
60601,01/29/2021,114,1791,103,1302,0.086,11,489,0.032,15083,POINT (-87.622844 41.886262),60601-20210129
60601,01/30/2021,34,1825,22,1324,0.088,12,501,0.033,15083,POINT (-87.622844 41.886262),60601-20210130
60601,01/31/2021,14,1839,11,1335,0.089,3,504,0.033,15083,POINT (-87.622844 41.886262),60601-20210131
60601,02/01/2021,42,1881,27,1362,0.09,15,519,0.034,15083,POINT (-87.622844 41.886262),60601-20210201
60601,02/02/2021,54,1935,31,1393,0.092,23,542,0.036,15083,POINT (-87.622844 41.886262),60601-20210202
60601,02/03/2021,68,2003,51,1444,0.096,17,559,0.037,15083,POINT (-87.622844 41.886262),60601-20210203
60601,02/04/2021,114,2117,96,1540,0.102,18,577,0.038,15083,POINT (-87.622844 41.886262),60601-20210204
60601,02/05/2021,120,2237,103,1643,0.109,17,594,0.039,15083,POINT (-87.622844 41.886262),60601-20210205
60601,02/06/2021,35,2272,19,1662,0.11,16,610,0.04,15083,POINT (-87.622844 41.886262),60601-20210206
60601,02/07/2021,20,2292,17,1679,0.111,3,613,0.041,15083,POINT (-87.622844 41.886262),60601-20210207
60601,02/08/2021,46,2338,34,1713,0.114,12,625,0.041,15083,POINT (-87.622844 41.886262),60601-20210208
60601,02/09/2021,46,2384,26,1739,0.115,20,645,0.043,15083,POINT (-87.622844 41.886262),60601-20210209
60827,02/14/2021,0,146,0,117,0.004,0,29,0.001,28483,POINT (-87.633087 41.650765),60827-20210214
60666,02/17/2021,1,24,1,22,0,0,2,0,0,POINT (-87.896371 41.979511),60666-20210217
60601,02/11/2021,135,2626,50,1871,0.124,85,755,0.05,15083,POINT (-87.622844 41.886262),60601-20210211
60601,02/12/2021,132,2758,37,1908,0.127,95,850,0.056,15083,POINT (-87.622844 41.886262),60601-20210212
60601,02/13/2021,46,2804,25,1933,0.128,21,871,0.058,15083,POINT (-87.622844 41.886262),60601-20210213
60601,02/14/2021,15,2819,6,1939,0.129,9,880,0.058,15083,POINT (-87.622844 41.886262),60601-20210214
60601,02/15/2021,20,2839,16,1955,0.13,4,884,0.059,15083,POINT (-87.622844 41.886262),60601-20210215
60601,02/16/2021,65,2904,56,2011,0.133,9,893,0.059,15083,POINT (-87.622844 41.886262),60601-20210216
60601,02/17/2021,75,2979,27,2038,0.135,48,941,0.062,15083,POINT (-87.622844 41.886262),60601-20210217
60603,02/16/2021,7,512,5,392,0.373,2,120,0.114,1052,POINT (-87.625473 41.880112),60603-20210216
60603,02/17/2021,10,522,3,395,0.375,7,127,0.121,1052,POINT (-87.625473 41.880112),60603-20210217
60601,02/10/2021,107,2491,82,1821,0.121,25,670,0.044,15083,POINT (-87.622844 41.886262),60601-20210210
60602,02/08/2021,10,381,7,300,0.262,3,81,0.071,1145,POINT (-87.628309 41.883136),60602-20210208
60602,02/09/2021,10,391,1,301,0.263,9,90,0.079,1145,POINT (-87.628309 41.883136),60602-20210209
60602,02/10/2021,14,405,9,310,0.271,5,95,0.083,1145,POINT (-87.628309 41.883136),60602-20210210
60602,02/11/2021,18,423,7,317,0.277,11,106,0.093,1145,POINT (-87.628309 41.883136),60602-20210211
60602,02/12/2021,34,457,13,330,0.288,21,127,0.111,1145,POINT (-87.628309 41.883136),60602-20210212
60602,02/13/2021,18,475,5,335,0.293,13,140,0.122,1145,POINT (-87.628309 41.883136),60602-20210213
60602,02/14/2021,2,477,1,336,0.293,1,141,0.123,1145,POINT (-87.628309 41.883136),60602-20210214
60602,02/15/2021,5,482,4,340,0.297,1,142,0.124,1145,POINT (-87.628309 41.883136),60602-20210215
60602,02/16/2021,10,492,7,347,0.303,3,145,0.127,1145,POINT (-87.628309 41.883136),60602-20210216
60602,02/17/2021,6,498,1,348,0.304,5,150,0.131,1145,POINT (-87.628309 41.883136),60602-20210217
60604,01/29/2021,22,179,20,163,0.198,2,16,0.019,823,POINT (-87.629029 41.878153),60604-20210129
60604,01/30/2021,1,180,1,164,0.199,0,16,0.019,823,POINT (-87.629029 41.878153),60604-20210130
60604,01/31/2021,2,182,1,165,0.2,1,17,0.021,823,POINT (-87.629029 41.878153),60604-20210131
60604,02/01/2021,5,187,5,170,0.207,0,17,0.021,823,POINT (-87.629029 41.878153),60604-20210201
60604,02/02/2021,8,195,7,177,0.215,1,18,0.022,823,POINT (-87.629029 41.878153),60604-20210202
60604,02/03/2021,7,202,6,183,0.222,1,19,0.023,823,POINT (-87.629029 41.878153),60604-20210203
60604,02/04/2021,5,207,5,188,0.228,0,19,0.023,823,POINT (-87.629029 41.878153),60604-20210204
60604,02/05/2021,10,217,8,196,0.238,2,21,0.026,823,POINT (-87.629029 41.878153),60604-20210205
60604,02/06/2021,3,220,1,197,0.239,2,23,0.028,823,POINT (-87.629029 41.878153),60604-20210206
60604,02/07/2021,1,221,1,198,0.241,0,23,0.028,823,POINT (-87.629029 41.878153),60604-20210207
60604,02/08/2021,8,229,7,205,0.249,1,24,0.029,823,POINT (-87.629029 41.878153),60604-20210208
60604,02/09/2021,19,248,14,219,0.266,5,29,0.035,823,POINT (-87.629029 41.878153),60604-20210209
60604,02/10/2021,18,266,8,227,0.276,10,39,0.047,823,POINT (-87.629029 41.878153),60604-20210210
60604,02/11/2021,18,284,11,238,0.289,7,46,0.056,823,POINT (-87.629029 41.878153),60604-20210211
60604,02/12/2021,14,298,4,242,0.294,10,56,0.068,823,POINT (-87.629029 41.878153),60604-20210212
60604,02/13/2021,6,304,2,244,0.296,4,60,0.073,823,POINT (-87.629029 41.878153),60604-20210213
60604,02/14/2021,2,306,0,244,0.296,2,62,0.075,823,POINT (-87.629029 41.878153),60604-20210214
60604,02/15/2021,0,306,0,244,0.296,0,62,0.075,823,POINT (-87.629029 41.878153),60604-20210215
60604,02/16/2021,4,310,3,247,0.3,1,63,0.077,823,POINT (-87.629029 41.878153),60604-20210216
60604,02/17/2021,6,316,2,249,0.303,4,67,0.081,823,POINT (-87.629029 41.878153),60604-20210217
60605,01/08/2021,285,2403,57,1915,0.066,228,488,0.017,29060,POINT (-87.623449 41.867824),60605-20210108
60605,01/09/2021,180,2583,30,1945,0.067,150,638,0.022,29060,POINT (-87.623449 41.867824),60605-20210109
60605,01/10/2021,62,2645,7,1952,0.067,55,693,0.024,29060,POINT (-87.623449 41.867824),60605-20210110
60605,01/11/2021,228,2873,41,1993,0.069,187,880,0.03,29060,POINT (-87.623449 41.867824),60605-20210111
60605,01/12/2021,229,3102,71,2064,0.071,158,1038,0.036,29060,POINT (-87.623449 41.867824),60605-20210112
60605,01/13/2021,160,3262,62,2126,0.073,98,1136,0.039,29060,POINT (-87.623449 41.867824),60605-20210113
60605,01/14/2021,96,3358,63,2189,0.075,33,1169,0.04,29060,POINT (-87.623449 41.867824),60605-20210114
60605,01/15/2021,85,3443,62,2251,0.077,23,1192,0.041,29060,POINT (-87.623449 41.867824),60605-20210115
60605,01/16/2021,52,3495,28,2279,0.078,24,1216,0.042,29060,POINT (-87.623449 41.867824),60605-20210116
60605,01/17/2021,29,3524,15,2294,0.079,14,1230,0.042,29060,POINT (-87.623449 41.867824),60605-20210117
60605,01/18/2021,93,3617,40,2334,0.08,53,1283,0.044,29060,POINT (-87.623449 41.867824),60605-20210118
60605,01/19/2021,120,3737,55,2389,0.082,65,1348,0.046,29060,POINT (-87.623449 41.867824),60605-20210119
60605,01/20/2021,128,3865,42,2431,0.084,86,1434,0.049,29060,POINT (-87.623449 41.867824),60605-20210120
60605,01/21/2021,169,4034,120,2551,0.088,49,1483,0.051,29060,POINT (-87.623449 41.867824),60605-20210121
60607,01/20/2021,257,3791,127,2544,0.087,130,1247,0.043,29293,POINT (-87.652727 41.876104),60607-20210120
60607,01/21/2021,212,4003,155,2699,0.092,57,1304,0.045,29293,POINT (-87.652727 41.876104),60607-20210121
60607,01/22/2021,169,4172,149,2848,0.097,20,1324,0.045,29293,POINT (-87.652727 41.876104),60607-20210122
60607,01/23/2021,52,4224,43,2891,0.099,9,1333,0.046,29293,POINT (-87.652727 41.876104),60607-20210123
60607,01/24/2021,18,4242,16,2907,0.099,2,1335,0.046,29293,POINT (-87.652727 41.876104),60607-20210124
60607,01/25/2021,193,4435,75,2982,0.102,118,1453,0.05,29293,POINT (-87.652727 41.876104),60607-20210125
60607,01/26/2021,281,4716,217,3199,0.109,64,1517,0.052,29293,POINT (-87.652727 41.876104),60607-20210126
60607,01/27/2021,172,4888,122,3321,0.113,50,1567,0.053,29293,POINT (-87.652727 41.876104),60607-20210127
60607,01/28/2021,239,5127,152,3473,0.119,87,1654,0.056,29293,POINT (-87.652727 41.876104),60607-20210128
60611,12/21/2020,424,1340,424,1340,0.04,0,0,0,33224,POINT (-87.620291 41.894734),60611-20201221
60611,12/22/2020,182,1522,182,1522,0.046,0,0,0,33224,POINT (-87.620291 41.894734),60611-20201222
60611,12/23/2020,67,1589,67,1589,0.048,0,0,0,33224,POINT (-87.620291 41.894734),60611-20201223
60611,12/24/2020,27,1616,27,1616,0.049,0,0,0,33224,POINT (-87.620291 41.894734),60611-20201224
60611,12/25/2020,0,1616,0,1616,0.049,0,0,0,33224,POINT (-87.620291 41.894734),60611-20201225
60611,12/26/2020,38,1654,38,1654,0.05,0,0,0,33224,POINT (-87.620291 41.894734),60611-20201226
60611,12/27/2020,0,1654,0,1654,0.05,0,0,0,33224,POINT (-87.620291 41.894734),60611-20201227
60611,12/28/2020,127,1781,127,1781,0.054,0,0,0,33224,POINT (-87.620291 41.894734),60611-20201228
60611,12/29/2020,120,1901,120,1901,0.057,0,0,0,33224,POINT (-87.620291 41.894734),60611-20201229
60611,12/30/2020,88,1989,88,1989,0.06,0,0,0,33224,POINT (-87.620291 41.894734),60611-20201230
60611,12/31/2020,26,2015,26,2015,0.061,0,0,0,33224,POINT (-87.620291 41.894734),60611-20201231
60611,01/01/2021,3,2018,3,2018,0.061,0,0,0,33224,POINT (-87.620291 41.894734),60611-20210101
60611,01/02/2021,32,2050,32,2050,0.062,0,0,0,33224,POINT (-87.620291 41.894734),60611-20210102
60611,01/03/2021,23,2073,23,2073,0.062,0,0,0,33224,POINT (-87.620291 41.894734),60611-20210103
60611,01/04/2021,54,2127,46,2119,0.064,8,8,0,33224,POINT (-87.620291 41.894734),60611-20210104
60611,01/05/2021,211,2338,192,2311,0.07,19,27,0.001,33224,POINT (-87.620291 41.894734),60611-20210105
60611,01/06/2021,75,2413,46,2357,0.071,29,56,0.002,33224,POINT (-87.620291 41.894734),60611-20210106
60612,01/21/2021,232,2554,185,1807,0.054,47,747,0.022,33735,POINT (-87.687011 41.88004),60612-20210121
60612,01/22/2021,116,2670,93,1900,0.056,23,770,0.023,33735,POINT (-87.687011 41.88004),60612-20210122
60612,01/23/2021,43,2713,39,1939,0.057,4,774,0.023,33735,POINT (-87.687011 41.88004),60612-20210123
60612,01/24/2021,5,2718,5,1944,0.058,0,774,0.023,33735,POINT (-87.687011 41.88004),60612-20210124
60612,01/25/2021,129,2847,51,1995,0.059,78,852,0.025,33735,POINT (-87.687011 41.88004),60612-20210125
60612,01/26/2021,104,2951,54,2049,0.061,50,902,0.027,33735,POINT (-87.687011 41.88004),60612-20210126
60612,01/27/2021,168,3119,134,2183,0.065,34,936,0.028,33735,POINT (-87.687011 41.88004),60612-20210127
60612,01/28/2021,180,3299,133,2316,0.069,47,983,0.029,33735,POINT (-87.687011 41.88004),60612-20210128
60613,01/12/2021,361,2799,251,2133,0.042,110,666,0.013,50761,POINT (-87.661343 41.953742),60613-20210112
60613,01/13/2021,176,2975,91,2224,0.044,85,751,0.015,50761,POINT (-87.661343 41.953742),60613-20210113
60613,01/14/2021,133,3108,108,2332,0.046,25,776,0.015,50761,POINT (-87.661343 41.953742),60613-20210114
60613,01/15/2021,110,3218,94,2426,0.048,16,792,0.016,50761,POINT (-87.661343 41.953742),60613-20210115
60613,01/16/2021,77,3295,64,2490,0.049,13,805,0.016,50761,POINT (-87.661343 41.953742),60613-20210116
60613,01/17/2021,41,3336,24,2514,0.05,17,822,0.016,50761,POINT (-87.661343 41.953742),60613-20210117
60613,01/18/2021,133,3469,68,2582,0.051,65,887,0.017,50761,POINT (-87.661343 41.953742),60613-20210118
60613,01/19/2021,153,3622,84,2666,0.053,69,956,0.019,50761,POINT (-87.661343 41.953742),60613-20210119
60613,01/20/2021,188,3810,117,2783,0.055,71,1027,0.02,50761,POINT (-87.661343 41.953742),60613-20210120
60613,01/21/2021,247,4057,205,2988,0.059,42,1069,0.021,50761,POINT (-87.661343 41.953742),60613-20210121
60616,01/14/2021,84,2337,56,1716,0.032,28,621,0.011,54197,POINT (-87.629531 41.844869),60616-20210114
60616,01/15/2021,74,2411,65,1781,0.033,9,630,0.012,54197,POINT (-87.629531 41.844869),60616-20210115
60616,01/16/2021,55,2466,36,1817,0.034,19,649,0.012,54197,POINT (-87.629531 41.844869),60616-20210116
60616,01/17/2021,18,2484,8,1825,0.034,10,659,0.012,54197,POINT (-87.629531 41.844869),60616-20210117
60616,01/18/2021,76,2560,36,1861,0.034,40,699,0.013,54197,POINT (-87.629531 41.844869),60616-20210118
60616,01/19/2021,126,2686,71,1932,0.036,55,754,0.014,54197,POINT (-87.629531 41.844869),60616-20210119
60616,01/20/2021,152,2838,92,2024,0.037,60,814,0.015,54197,POINT (-87.629531 41.844869),60616-20210120
60616,01/21/2021,194,3032,160,2184,0.04,34,848,0.016,54197,POINT (-87.629531 41.844869),60616-20210121
60618,01/20/2021,299,4392,186,3198,0.034,113,1194,0.013,94907,POINT (-87.703343 41.946699),60618-20210120
60619,01/20/2021,122,1182,90,1003,0.016,32,179,0.003,61207,POINT (-87.60569 41.744737),60619-20210120
60619,01/21/2021,183,1365,153,1156,0.019,30,209,0.003,61207,POINT (-87.60569 41.744737),60619-20210121
60619,01/22/2021,260,1625,251,1407,0.023,9,218,0.004,61207,POINT (-87.60569 41.744737),60619-20210122
60619,01/23/2021,101,1726,98,1505,0.025,3,221,0.004,61207,POINT (-87.60569 41.744737),60619-20210123
60619,01/24/2021,30,1756,28,1533,0.025,2,223,0.004,61207,POINT (-87.60569 41.744737),60619-20210124
60620,01/21/2021,127,1212,107,1004,0.015,20,208,0.003,67711,POINT (-87.651656 41.740873),60620-20210121
60620,01/22/2021,101,1313,92,1096,0.016,9,217,0.003,67711,POINT (-87.651656 41.740873),60620-20210122
60623,01/20/2021,118,1381,86,1161,0.014,32,220,0.003,81283,POINT (-87.717446 41.850321),60623-20210120
60623,01/21/2021,132,1513,116,1277,0.016,16,236,0.003,81283,POINT (-87.717446 41.850321),60623-20210121
60629,01/20/2021,145,1825,97,1446,0.013,48,379,0.003,110029,POINT (-87.711565 41.777061),60629-20210120
60629,01/21/2021,245,2070,222,1668,0.015,23,402,0.004,110029,POINT (-87.711565 41.777061),60629-20210121
60632,01/20/2021,153,1367,114,1121,0.012,39,246,0.003,89857,POINT (-87.711251 41.810038),60632-20210120
60632,01/21/2021,132,1499,114,1235,0.014,18,264,0.003,89857,POINT (-87.711251 41.810038),60632-20210121
60637,01/19/2021,214,2105,183,1610,0.034,31,495,0.01,47300,POINT (-87.604053 41.780991),60637-20210119
60637,01/20/2021,188,2293,133,1743,0.037,55,550,0.012,47300,POINT (-87.604053 41.780991),60637-20210120
60637,01/21/2021,253,2546,209,1952,0.041,44,594,0.013,47300,POINT (-87.604053 41.780991),60637-20210121
60638,01/20/2021,126,1681,84,1263,0.022,42,418,0.007,58669,POINT (-87.771902 41.787032),60638-20210120
60638,01/21/2021,153,1834,128,1391,0.024,25,443,0.008,58669,POINT (-87.771902 41.787032),60638-20210121
60641,01/19/2021,114,2184,73,1684,0.024,41,500,0.007,69880,POINT (-87.746791 41.946682),60641-20210119
60641,01/20/2021,179,2363,124,1808,0.026,55,555,0.008,69880,POINT (-87.746791 41.946682),60641-20210120
60643,01/20/2021,147,1941,112,1563,0.032,35,378,0.008,48887,POINT (-87.662381 41.700445),60643-20210120
60643,01/21/2021,181,2122,166,1729,0.035,15,393,0.008,48887,POINT (-87.662381 41.700445),60643-20210121
60644,01/20/2021,56,1047,38,932,0.02,18,115,0.002,46591,POINT (-87.756863 41.881113),60644-20210120
60644,01/21/2021,85,1132,78,1010,0.022,7,122,0.003,46591,POINT (-87.756863 41.881113),60644-20210121
60645,01/20/2021,152,2129,107,1770,0.037,45,359,0.008,47270,POINT (-87.695049 42.008927),60645-20210120
60645,01/21/2021,150,2279,122,1892,0.04,28,387,0.008,47270,POINT (-87.695049 42.008927),60645-20210121
60646,01/11/2021,65,921,14,703,0.025,51,218,0.008,28569,POINT (-87.761826 41.993931),60646-20210111
60646,01/12/2021,55,976,26,729,0.026,29,247,0.009,28569,POINT (-87.761826 41.993931),60646-20210112
60646,01/13/2021,178,1154,137,866,0.03,41,288,0.01,28569,POINT (-87.761826 41.993931),60646-20210113
60646,01/14/2021,43,1197,33,899,0.031,10,298,0.01,28569,POINT (-87.761826 41.993931),60646-20210114
60646,01/15/2021,54,1251,50,949,0.033,4,302,0.011,28569,POINT (-87.761826 41.993931),60646-20210115
60646,01/16/2021,33,1284,30,979,0.034,3,305,0.011,28569,POINT (-87.761826 41.993931),60646-20210116
60646,01/17/2021,22,1306,15,994,0.035,7,312,0.011,28569,POINT (-87.761826 41.993931),60646-20210117
60646,01/18/2021,48,1354,34,1028,0.036,14,326,0.011,28569,POINT (-87.761826 41.993931),60646-20210118
60646,01/19/2021,75,1429,62,1090,0.038,13,339,0.012,28569,POINT (-87.761826 41.993931),60646-20210119
60646,01/20/2021,119,1548,88,1178,0.041,31,370,0.013,28569,POINT (-87.761826 41.993931),60646-20210120
60646,01/21/2021,163,1711,138,1316,0.046,25,395,0.014,28569,POINT (-87.761826 41.993931),60646-20210121
60646,01/22/2021,129,1840,118,1434,0.05,11,406,0.014,28569,POINT (-87.761826 41.993931),60646-20210122
60649,01/19/2021,188,1260,172,1123,0.024,16,137,0.003,46633,POINT (-87.571522 41.762202),60649-20210119
60649,01/20/2021,101,1361,83,1206,0.026,18,155,0.003,46633,POINT (-87.571522 41.762202),60649-20210120
60649,01/21/2021,147,1508,129,1335,0.029,18,173,0.004,46633,POINT (-87.571522 41.762202),60649-20210121
60652,01/30/2021,78,1994,66,1540,0.035,12,454,0.01,43447,POINT (-87.714238 41.745398),60652-20210130
60652,01/31/2021,11,2005,7,1547,0.036,4,458,0.011,43447,POINT (-87.714238 41.745398),60652-20210131
60603,12/25/2020,0,36,0,36,0.034,0,0,0,1052,POINT (-87.625473 41.880112),60603-20201225
60606,01/29/2021,26,481,22,342,0.104,4,139,0.042,3287,POINT (-87.63676 41.882634),60606-20210129
60610,02/06/2021,111,6211,76,4741,0.117,35,1470,0.036,40548,POINT (-87.63581 41.90455),60610-20210206
60613,01/25/2021,193,4667,149,3515,0.069,44,1152,0.023,50761,POINT (-87.661343 41.953742),60613-20210125
60614,02/13/2021,248,13114,144,9302,0.129,104,3812,0.053,71954,POINT (-87.652064 41.922605),60614-20210213
60621,01/26/2021,35,671,23,600,0.021,12,71,0.003,28018,POINT (-87.638812 41.776931),60621-20210126
60621,02/10/2021,76,1443,56,1190,0.042,20,253,0.009,28018,POINT (-87.638812 41.776931),60621-20210210
60622,01/09/2021,249,3446,52,2738,0.051,197,708,0.013,53294,POINT (-87.681818 41.902762),60622-20210109
60623,02/14/2021,21,6427,13,5286,0.065,8,1141,0.014,81283,POINT (-87.717446 41.850321),60623-20210214
60624,01/13/2021,31,332,21,283,0.008,10,49,0.001,34892,POINT (-87.722735 41.879417),60624-20210113
60625,02/03/2021,378,7013,263,5426,0.068,115,1587,0.02,79444,POINT (-87.701816 41.971155),60625-20210203
60611,12/20/2020,21,916,21,916,0.028,0,0,0,33224,POINT (-87.620291 41.894734),60611-20201220
60628,02/07/2021,46,3404,45,2865,0.045,1,539,0.008,64254,POINT (-87.621537 41.694192),60628-20210207
60602,12/20/2020,2,15,2,15,0.013,0,0,0,1145,POINT (-87.628309 41.883136),60602-20201220
60630,01/15/2021,72,1843,66,1434,0.025,6,409,0.007,56433,POINT (-87.759611 41.971261),60630-20210115
60652,12/28/2020,98,254,98,254,0.006,0,0,0,43447,POINT (-87.714238 41.745398),60652-20201228
60628,12/16/2020,0,0,0,0,0,0,0,0,64254,POINT (-87.621537 41.694192),60628-20201216
60617,12/27/2020,0,202,0,202,0.002,0,0,0,83553,POINT (-87.556897 41.721257),60617-20201227
60644,12/21/2020,17,47,17,47,0.001,0,0,0,46591,POINT (-87.756863 41.881113),60644-20201221
60634,01/30/2021,225,4698,134,3729,0.05,91,969,0.013,75082,POINT (-87.797373 41.944967),60634-20210130
60641,01/04/2021,110,820,110,820,0.012,0,0,0,69880,POINT (-87.746791 41.946682),60641-20210104
60631,01/07/2021,98,874,37,793,0.027,61,81,0.003,29529,POINT (-87.813371 41.995019),60631-20210107
60623,12/18/2020,26,38,26,38,0,0,0,0,81283,POINT (-87.717446 41.850321),60623-20201218
60637,01/07/2021,85,1020,45,937,0.02,40,83,0.002,47300,POINT (-87.604053 41.780991),60637-20210107
60617,12/15/2020,0,0,0,0,0,0,0,0,83553,POINT (-87.556897 41.721257),60617-20201215
60649,12/24/2020,14,120,14,120,0.003,0,0,0,46633,POINT (-87.571522 41.762202),60649-20201224
Unknown,02/07/2021,3,1249,3,955,0,0,294,0,0,,Unknown-20210207
60619,12/31/2020,23,267,23,267,0.004,0,0,0,61207,POINT (-87.60569 41.744737),60619-20201231
60633,01/31/2021,2,416,2,343,0.027,0,73,0.006,12689,POINT (-87.556037 41.653147),60633-20210131
60639,12/17/2020,7,10,7,10,0,0,0,0,88204,POINT (-87.75531 41.920609),60639-20201217
60652,02/01/2021,94,2099,78,1625,0.037,16,474,0.011,43447,POINT (-87.714238 41.745398),60652-20210201
60657,01/01/2021,4,2069,4,2069,0.029,0,0,0,70958,POINT (-87.658216 41.939715),60657-20210101
60652,02/02/2021,127,2226,94,1719,0.04,33,507,0.012,43447,POINT (-87.714238 41.745398),60652-20210202
60652,02/03/2021,199,2425,157,1876,0.043,42,549,0.013,43447,POINT (-87.714238 41.745398),60652-20210203
60639,01/16/2021,53,1359,50,1155,0.013,3,204,0.002,88204,POINT (-87.75531 41.920609),60639-20210116
60652,12/15/2020,1,1,1,1,0,0,0,0,43447,POINT (-87.714238 41.745398),60652-20201215
60636,01/03/2021,1,88,1,88,0.003,0,0,0,30024,POINT (-87.668597 41.77599),60636-20210103
60608,01/15/2021,86,2406,78,1883,0.024,8,523,0.007,80059,POINT (-87.670366 41.849879),60608-20210115
60707,12/28/2020,6,81,6,81,0.002,0,0,0,43093,POINT (-87.808283 41.921777),60707-20201228
60633,12/26/2020,0,26,0,26,0.002,0,0,0,12689,POINT (-87.556037 41.653147),60633-20201226
60638,01/07/2021,84,788,38,729,0.012,46,59,0.001,58669,POINT (-87.771902 41.787032),60638-20210107
60652,02/04/2021,178,2603,149,2025,0.047,29,578,0.013,43447,POINT (-87.714238 41.745398),60652-20210204
Unknown,01/06/2021,13,120,13,120,0,0,0,0,0,,Unknown-20210106
60625,01/07/2021,137,1746,71,1660,0.021,66,86,0.001,79444,POINT (-87.701816 41.971155),60625-20210107
60618,01/01/2021,2,1413,2,1413,0.015,0,0,0,94907,POINT (-87.703343 41.946699),60618-20210101
60606,01/11/2021,23,228,5,161,0.049,18,67,0.02,3287,POINT (-87.63676 41.882634),60606-20210111
60707,01/02/2021,2,122,2,122,0.003,0,0,0,43093,POINT (-87.808283 41.921777),60707-20210102
60629,12/16/2020,2,2,2,2,0,0,0,0,110029,POINT (-87.711565 41.777061),60629-20201216
60620,01/05/2021,37,342,33,333,0.005,4,9,0,67711,POINT (-87.651656 41.740873),60620-20210105
60614,12/29/2020,188,1610,188,1610,0.022,0,0,0,71954,POINT (-87.652064 41.922605),60614-20201229
60660,01/05/2021,77,801,76,796,0.018,1,5,0,44498,POINT (-87.666362 41.991062),60660-20210105
60606,12/28/2020,5,97,5,97,0.03,0,0,0,3287,POINT (-87.63676 41.882634),60606-20201228
60617,12/22/2020,41,157,41,157,0.002,0,0,0,83553,POINT (-87.556897 41.721257),60617-20201222
60641,01/15/2021,96,1895,84,1485,0.021,12,410,0.006,69880,POINT (-87.746791 41.946682),60641-20210115
60630,01/10/2021,17,1344,7,1111,0.02,10,233,0.004,56433,POINT (-87.759611 41.971261),60630-20210110
60643,01/19/2021,126,1794,101,1451,0.03,25,343,0.007,48887,POINT (-87.662381 41.700445),60643-20210119
60653,01/29/2021,182,2120,169,1711,0.052,13,409,0.012,33154,POINT (-87.611244 41.819261),60653-20210129
60609,12/21/2020,31,103,31,103,0.002,0,0,0,60939,POINT (-87.653382 41.812017),60609-20201221
60642,12/18/2020,135,187,135,187,0.009,0,0,0,19716,POINT (-87.657821 41.899935),60642-20201218
60616,12/17/2020,60,63,60,63,0.001,0,0,0,54197,POINT (-87.629531 41.844869),60616-20201217
60608,01/04/2021,97,1033,91,1027,0.013,6,6,0,80059,POINT (-87.670366 41.849879),60608-20210104
60601,12/15/2020,0,0,0,0,0,0,0,0,15083,POINT (-87.622844 41.886262),60601-20201215
60619,01/11/2021,37,554,21,487,0.008,16,67,0.001,61207,POINT (-87.60569 41.744737),60619-20210111
60639,01/11/2021,79,963,51,837,0.009,28,126,0.001,88204,POINT (-87.75531 41.920609),60639-20210111
60621,12/30/2020,71,177,71,177,0.006,0,0,0,28018,POINT (-87.638812 41.776931),60621-20201230
60654,01/21/2021,93,1853,77,1214,0.061,16,639,0.032,20022,POINT (-87.636354 41.892485),60654-20210121
60632,01/14/2021,69,948,59,809,0.009,10,139,0.002,89857,POINT (-87.711251 41.810038),60632-20210114
60602,01/08/2021,10,73,3,63,0.055,7,10,0.009,1145,POINT (-87.628309 41.883136),60602-20210108
60625,12/28/2020,60,703,60,703,0.009,0,0,0,79444,POINT (-87.701816 41.971155),60625-20201228
60625,01/02/2021,32,1022,32,1022,0.013,0,0,0,79444,POINT (-87.701816 41.971155),60625-20210102
60618,01/06/2021,127,1916,109,1880,0.02,18,36,0,94907,POINT (-87.703343 41.946699),60618-20210106
60628,01/06/2021,29,426,28,424,0.007,1,2,0,64254,POINT (-87.621537 41.694192),60628-20210106
60608,01/17/2021,13,2476,10,1945,0.024,3,531,0.007,80059,POINT (-87.670366 41.849879),60608-20210117
60606,01/16/2021,7,277,5,187,0.057,2,90,0.027,3287,POINT (-87.63676 41.882634),60606-20210116
60638,12/25/2020,0,322,0,322,0.005,0,0,0,58669,POINT (-87.771902 41.787032),60638-20201225
60607,01/08/2021,277,2262,71,1887,0.064,206,375,0.013,29293,POINT (-87.652727 41.876104),60607-20210108
60707,01/16/2021,10,324,10,259,0.006,0,65,0.002,43093,POINT (-87.808283 41.921777),60707-20210116
60637,01/18/2021,181,1891,149,1427,0.03,32,464,0.01,47300,POINT (-87.604053 41.780991),60637-20210118
60661,12/29/2020,33,406,33,406,0.039,0,0,0,10354,POINT (-87.644283 41.882786),60661-20201229
60629,01/06/2021,46,703,40,694,0.006,6,9,0,110029,POINT (-87.711565 41.777061),60629-20210106
60642,12/31/2020,28,698,28,698,0.035,0,0,0,19716,POINT (-87.657821 41.899935),60642-20201231
60616,01/01/2021,2,918,2,918,0.017,0,0,0,54197,POINT (-87.629531 41.844869),60616-20210101
60707,01/17/2021,0,324,0,259,0.006,0,65,0.002,43093,POINT (-87.808283 41.921777),60707-20210117
60609,12/26/2020,2,182,2,182,0.003,0,0,0,60939,POINT (-87.653382 41.812017),60609-20201226
60619,12/21/2020,18,67,18,67,0.001,0,0,0,61207,POINT (-87.60569 41.744737),60619-20201221
60639,12/20/2020,5,90,5,90,0.001,0,0,0,88204,POINT (-87.75531 41.920609),60639-20201220
60610,12/21/2020,133,480,133,480,0.012,0,0,0,40548,POINT (-87.63581 41.90455),60610-20201221
60653,12/15/2020,0,0,0,0,0,0,0,0,33154,POINT (-87.611244 41.819261),60653-20201215
60632,12/19/2020,10,47,10,47,0.001,0,0,0,89857,POINT (-87.711251 41.810038),60632-20201219
60654,01/24/2021,21,2020,20,1359,0.068,1,661,0.033,20022,POINT (-87.636354 41.892485),60654-20210124
60636,12/20/2020,0,9,0,9,0,0,0,0,30024,POINT (-87.668597 41.77599),60636-20201220
60654,01/25/2021,76,2096,62,1421,0.071,14,675,0.034,20022,POINT (-87.636354 41.892485),60654-20210125
60612,01/10/2021,13,1310,6,1098,0.033,7,212,0.006,33735,POINT (-87.687011 41.88004),60612-20210110
60621,12/25/2020,0,33,0,33,0.001,0,0,0,28018,POINT (-87.638812 41.776931),60621-20201225
60631,01/10/2021,18,1140,1,915,0.031,17,225,0.008,29529,POINT (-87.813371 41.995019),60631-20210110
60623,01/19/2021,76,1263,45,1075,0.013,31,188,0.002,81283,POINT (-87.717446 41.850321),60623-20210119
60643,01/14/2021,51,1467,46,1176,0.024,5,291,0.006,48887,POINT (-87.662381 41.700445),60643-20210114
60644,01/19/2021,26,991,9,894,0.019,17,97,0.002,46591,POINT (-87.756863 41.881113),60644-20210119
60625,01/17/2021,45,2999,31,2372,0.03,14,627,0.008,79444,POINT (-87.701816 41.971155),60625-20210117
60644,01/04/2021,32,338,32,338,0.007,0,0,0,46591,POINT (-87.756863 41.881113),60644-20210104
Unknown,01/21/2021,103,624,99,540,0,4,84,0,0,,Unknown-20210121
60649,01/12/2021,95,792,80,713,0.015,15,79,0.002,46633,POINT (-87.571522 41.762202),60649-20210112
60642,01/15/2021,58,1597,47,1094,0.055,11,503,0.026,19716,POINT (-87.657821 41.899935),60642-20210115
60640,12/28/2020,83,825,83,825,0.012,0,0,0,69363,POINT (-87.662232 41.971888),60640-20201228
60640,01/11/2021,285,3067,162,2605,0.038,123,462,0.007,69363,POINT (-87.662232 41.971888),60640-20210111
60651,12/24/2020,6,112,6,112,0.002,0,0,0,63492,POINT (-87.741017 41.901964),60651-20201224
60653,01/10/2021,13,676,3,592,0.018,10,84,0.003,33154,POINT (-87.611244 41.819261),60653-20210110
60661,01/13/2021,56,973,25,652,0.063,31,321,0.031,10354,POINT (-87.644283 41.882786),60661-20210113
60654,02/09/2021,78,3239,53,2256,0.113,25,983,0.049,20022,POINT (-87.636354 41.892485),60654-20210209
60630,12/31/2020,44,650,44,650,0.012,0,0,0,56433,POINT (-87.759611 41.971261),60630-20201231
60654,02/10/2021,223,3462,187,2443,0.122,36,1019,0.051,20022,POINT (-87.636354 41.892485),60654-20210210
60626,01/02/2021,13,759,13,759,0.015,0,0,0,50544,POINT (-87.669834 42.009469),60626-20210102
60656,01/05/2021,25,361,25,361,0.013,0,0,0,28218,POINT (-87.817934 41.974566),60656-20210105
60652,01/16/2021,26,880,19,735,0.017,7,145,0.003,43447,POINT (-87.714238 41.745398),60652-20210116
60654,02/11/2021,103,3565,43,2486,0.124,60,1079,0.054,20022,POINT (-87.636354 41.892485),60654-20210211
60660,12/19/2020,53,176,53,176,0.004,0,0,0,44498,POINT (-87.666362 41.991062),60660-20201219
60623,12/29/2020,50,302,50,302,0.004,0,0,0,81283,POINT (-87.717446 41.850321),60623-20201229
60651,12/18/2020,28,33,28,33,0.001,0,0,0,63492,POINT (-87.741017 41.901964),60651-20201218
60654,02/12/2021,139,3704,66,2552,0.127,73,1152,0.058,20022,POINT (-87.636354 41.892485),60654-20210212
60632,01/03/2021,6,422,6,422,0.005,0,0,0,89857,POINT (-87.711251 41.810038),60632-20210103
60638,12/23/2020,34,311,34,311,0.005,0,0,0,58669,POINT (-87.771902 41.787032),60638-20201223
60654,02/13/2021,71,3775,40,2592,0.129,31,1183,0.059,20022,POINT (-87.636354 41.892485),60654-20210213
60655,01/14/2021,91,1398,77,1041,0.036,14,357,0.012,28569,POINT (-87.701434 41.696456),60655-20210114
60625,12/23/2020,107,607,107,607,0.008,0,0,0,79444,POINT (-87.701816 41.971155),60625-20201223
60610,01/05/2021,123,1117,114,1100,0.027,9,17,0,40548,POINT (-87.63581 41.90455),60610-20210105
60633,01/14/2021,3,125,2,102,0.008,1,23,0.002,12689,POINT (-87.556037 41.653147),60633-20210114
60601,12/20/2020,9,148,9,148,0.01,0,0,0,15083,POINT (-87.622844 41.886262),60601-20201220
60629,12/15/2020,0,0,0,0,0,0,0,0,110029,POINT (-87.711565 41.777061),60629-20201215
60655,01/27/2021,228,2530,202,2008,0.07,26,522,0.018,28569,POINT (-87.701434 41.696456),60655-20210127
60623,01/13/2021,69,1010,36,881,0.011,33,129,0.002,81283,POINT (-87.717446 41.850321),60623-20210113
60652,12/19/2020,11,51,11,51,0.001,0,0,0,43447,POINT (-87.714238 41.745398),60652-20201219
60653,01/20/2021,62,1153,38,923,0.028,24,230,0.007,33154,POINT (-87.611244 41.819261),60653-20210120
60608,12/16/2020,0,0,0,0,0,0,0,0,80059,POINT (-87.670366 41.849879),60608-20201216
60636,12/17/2020,3,3,3,3,0,0,0,0,30024,POINT (-87.668597 41.77599),60636-20201217
60640,12/27/2020,0,742,0,742,0.011,0,0,0,69363,POINT (-87.662232 41.971888),60640-20201227
60630,12/16/2020,4,4,4,4,0,0,0,0,56433,POINT (-87.759611 41.971261),60630-20201216
60628,01/12/2021,43,626,29,551,0.009,14,75,0.001,64254,POINT (-87.621537 41.694192),60628-20210112
60621,01/09/2021,6,258,2,242,0.009,4,16,0.001,28018,POINT (-87.638812 41.776931),60621-20210109
60655,01/28/2021,230,2760,193,2201,0.077,37,559,0.02,28569,POINT (-87.701434 41.696456),60655-20210128
60655,01/29/2021,173,2933,144,2345,0.082,29,588,0.021,28569,POINT (-87.701434 41.696456),60655-20210129
60617,01/01/2021,1,363,1,363,0.004,0,0,0,83553,POINT (-87.556897 41.721257),60617-20210101
60619,01/05/2021,36,349,34,345,0.006,2,4,0,61207,POINT (-87.60569 41.744737),60619-20210105
60624,12/29/2020,16,81,16,81,0.002,0,0,0,34892,POINT (-87.722735 41.879417),60624-20201229
60609,01/22/2021,114,1513,111,1230,0.02,3,283,0.005,60939,POINT (-87.653382 41.812017),60609-20210122
60601,12/25/2020,0,307,0,307,0.02,0,0,0,15083,POINT (-87.622844 41.886262),60601-20201225
60637,01/03/2021,84,710,79,705,0.015,5,5,0,47300,POINT (-87.604053 41.780991),60637-20210103
60652,12/24/2020,9,154,9,154,0.004,0,0,0,43447,POINT (-87.714238 41.745398),60652-20201224
60624,01/09/2021,11,244,8,221,0.006,3,23,0.001,34892,POINT (-87.722735 41.879417),60624-20210109
60633,02/04/2021,35,528,25,438,0.035,10,90,0.007,12689,POINT (-87.556037 41.653147),60633-20210204
60623,01/02/2021,13,407,13,407,0.005,0,0,0,81283,POINT (-87.717446 41.850321),60623-20210102
60656,02/09/2021,148,2479,123,1967,0.07,25,512,0.018,28218,POINT (-87.817934 41.974566),60656-20210209
60661,12/25/2020,0,351,0,351,0.034,0,0,0,10354,POINT (-87.644283 41.882786),60661-20201225
60628,12/22/2020,17,81,17,81,0.001,0,0,0,64254,POINT (-87.621537 41.694192),60628-20201222
Unknown,01/02/2021,1,88,1,88,0,0,0,0,0,,Unknown-20210102
60626,12/23/2020,49,323,49,323,0.006,0,0,0,50544,POINT (-87.669834 42.009469),60626-20201223
60655,01/01/2021,0,529,0,529,0.019,0,0,0,28569,POINT (-87.701434 41.696456),60655-20210101
60607,12/16/2020,4,5,4,5,0,0,0,0,29293,POINT (-87.652727 41.876104),60607-20201216
60607,12/15/2020,1,1,1,1,0,0,0,0,29293,POINT (-87.652727 41.876104),60607-20201215
60652,01/25/2021,177,1423,73,1078,0.025,104,345,0.008,43447,POINT (-87.714238 41.745398),60652-20210125
60827,01/17/2021,0,35,0,30,0.001,0,5,0,28483,POINT (-87.633087 41.650765),60827-20210117
60629,01/12/2021,103,1121,55,913,0.008,48,208,0.002,110029,POINT (-87.711565 41.777061),60629-20210112
60621,01/14/2021,9,307,8,278,0.01,1,29,0.001,28018,POINT (-87.638812 41.776931),60621-20210114
60609,01/05/2021,37,412,34,409,0.007,3,3,0,60939,POINT (-87.653382 41.812017),60609-20210105
60656,02/10/2021,143,2622,117,2084,0.074,26,538,0.019,28218,POINT (-87.817934 41.974566),60656-20210210
60657,12/19/2020,227,721,227,721,0.01,0,0,0,70958,POINT (-87.658216 41.939715),60657-20201219
60707,12/15/2020,0,0,0,0,0,0,0,0,43093,POINT (-87.808283 41.921777),60707-20201215
60656,02/11/2021,162,2784,123,2207,0.078,39,577,0.02,28218,POINT (-87.817934 41.974566),60656-20210211
60707,12/16/2020,1,1,1,1,0,0,0,0,43093,POINT (-87.808283 41.921777),60707-20201216
60652,01/20/2021,75,1040,44,827,0.019,31,213,0.005,43447,POINT (-87.714238 41.745398),60652-20210120
60629,12/22/2020,47,215,47,215,0.002,0,0,0,110029,POINT (-87.711565 41.777061),60629-20201222
60631,12/26/2020,6,347,6,347,0.012,0,0,0,29529,POINT (-87.813371 41.995019),60631-20201226
60629,01/17/2021,9,1521,6,1254,0.011,3,267,0.002,110029,POINT (-87.711565 41.777061),60629-20210117
60637,12/23/2020,68,324,68,324,0.007,0,0,0,47300,POINT (-87.604053 41.780991),60637-20201223
60619,12/27/2020,0,121,0,121,0.002,0,0,0,61207,POINT (-87.60569 41.744737),60619-20201227
60633,12/30/2020,8,45,8,45,0.004,0,0,0,12689,POINT (-87.556037 41.653147),60633-20201230
60639,12/27/2020,0,217,0,217,0.002,0,0,0,88204,POINT (-87.75531 41.920609),60639-20201227
60612,12/26/2020,4,527,4,527,0.016,0,0,0,33735,POINT (-87.687011 41.88004),60612-20201226
60641,12/31/2020,30,670,30,670,0.01,0,0,0,69880,POINT (-87.746791 41.946682),60641-20201231
60657,12/25/2020,0,1448,0,1448,0.02,0,0,0,70958,POINT (-87.658216 41.939715),60657-20201225
60636,01/13/2021,19,212,15,189,0.006,4,23,0.001,30024,POINT (-87.668597 41.77599),60636-20210113
60641,12/17/2020,33,51,33,51,0.001,0,0,0,69880,POINT (-87.746791 41.946682),60641-20201217
60631,12/31/2020,16,471,16,471,0.016,0,0,0,29529,POINT (-87.813371 41.995019),60631-20201231
60645,01/08/2021,127,1270,61,1154,0.024,66,116,0.002,47270,POINT (-87.695049 42.008927),60645-20210108
60608,01/08/2021,188,1472,88,1302,0.016,100,170,0.002,80059,POINT (-87.670366 41.849879),60608-20210108
60666,01/16/2021,0,1,0,1,0,0,0,0,0,POINT (-87.896371 41.979511),60666-20210116
60620,01/01/2021,0,257,0,257,0.004,0,0,0,67711,POINT (-87.651656 41.740873),60620-20210101
Unknown,12/20/2020,1,10,1,10,0,0,0,0,0,,Unknown-20201220
60644,12/18/2020,14,18,14,18,0,0,0,0,46591,POINT (-87.756863 41.881113),60644-20201218
60633,12/19/2020,5,9,5,9,0.001,0,0,0,12689,POINT (-87.556037 41.653147),60633-20201219
Unknown,02/03/2021,60,1065,28,872,0,32,193,0,0,,Unknown-20210203
60641,01/11/2021,100,1415,40,1138,0.016,60,277,0.004,69880,POINT (-87.746791 41.946682),60641-20210111
60657,01/24/2021,68,7340,58,5321,0.075,10,2019,0.028,70958,POINT (-87.658216 41.939715),60657-20210124
60609,01/10/2021,14,695,3,623,0.01,11,72,0.001,60939,POINT (-87.653382 41.812017),60609-20210110
60643,01/04/2021,31,513,31,512,0.01,0,1,0,48887,POINT (-87.662381 41.700445),60643-20210104
60649,01/05/2021,33,376,31,372,0.008,2,4,0,46633,POINT (-87.571522 41.762202),60649-20210105
60653,01/15/2021,26,944,21,780,0.024,5,164,0.005,33154,POINT (-87.611244 41.819261),60653-20210115
60633,02/11/2021,60,793,48,648,0.051,12,145,0.011,12689,POINT (-87.556037 41.653147),60633-20210211
60655,01/20/2021,83,1662,60,1255,0.044,23,407,0.014,28569,POINT (-87.701434 41.696456),60655-20210120
60632,01/18/2021,53,1119,34,945,0.011,19,174,0.002,89857,POINT (-87.711251 41.810038),60632-20210118
60606,01/04/2021,10,139,7,136,0.041,3,3,0.001,3287,POINT (-87.63676 41.882634),60606-20210104
60636,01/18/2021,12,257,7,225,0.007,5,32,0.001,30024,POINT (-87.668597 41.77599),60636-20210118
60656,02/02/2021,84,1724,64,1344,0.048,20,380,0.013,28218,POINT (-87.817934 41.974566),60656-20210202
60622,12/25/2020,0,1360,0,1360,0.026,0,0,0,53294,POINT (-87.681818 41.902762),60622-20201225
60620,12/21/2020,13,82,13,82,0.001,0,0,0,67711,POINT (-87.651656 41.740873),60620-20201221
60827,12/20/2020,0,4,0,4,0,0,0,0,28483,POINT (-87.633087 41.650765),60827-20201220
60656,12/27/2020,0,197,0,197,0.007,0,0,0,28218,POINT (-87.817934 41.974566),60656-20201227
60643,12/30/2020,66,440,66,440,0.009,0,0,0,48887,POINT (-87.662381 41.700445),60643-20201230
60659,01/19/2021,86,1611,50,1324,0.031,36,287,0.007,42735,POINT (-87.703266 41.990803),60659-20210119
60618,12/22/2020,137,766,137,766,0.008,0,0,0,94907,POINT (-87.703343 41.946699),60618-20201222
60607,01/04/2021,159,1608,150,1598,0.055,9,10,0,29293,POINT (-87.652727 41.876104),60607-20210104
60657,12/22/2020,205,1252,205,1252,0.018,0,0,0,70958,POINT (-87.658216 41.939715),60657-20201222
60629,01/02/2021,17,540,17,540,0.005,0,0,0,110029,POINT (-87.711565 41.777061),60629-20210102
60657,02/11/2021,504,13335,260,9446,0.133,244,3889,0.055,70958,POINT (-87.658216 41.939715),60657-20210211
60657,02/12/2021,520,13855,274,9720,0.137,246,4135,0.058,70958,POINT (-87.658216 41.939715),60657-20210212
60666,01/29/2021,3,9,3,9,0,0,0,0,0,POINT (-87.896371 41.979511),60666-20210129
60656,01/28/2021,101,1393,86,1075,0.038,15,318,0.011,28218,POINT (-87.817934 41.974566),60656-20210128
60607,01/17/2021,13,3295,9,2311,0.079,4,984,0.034,29293,POINT (-87.652727 41.876104),60607-20210117
60661,01/09/2021,66,787,7,599,0.058,59,188,0.018,10354,POINT (-87.644283 41.882786),60661-20210109
60659,01/29/2021,116,2611,100,2077,0.049,16,534,0.012,42735,POINT (-87.703266 41.990803),60659-20210129
60623,01/17/2021,7,1148,7,1006,0.012,0,142,0.002,81283,POINT (-87.717446 41.850321),60623-20210117
60666,02/03/2021,1,13,1,13,0,0,0,0,0,POINT (-87.896371 41.979511),60666-20210203
60645,01/19/2021,82,1977,54,1663,0.035,28,314,0.007,47270,POINT (-87.695049 42.008927),60645-20210119
60659,01/30/2021,90,2701,82,2159,0.051,8,542,0.013,42735,POINT (-87.703266 41.990803),60659-20210130
60641,12/15/2020,0,0,0,0,0,0,0,0,69880,POINT (-87.746791 41.946682),60641-20201215
60657,01/06/2021,148,2715,99,2643,0.037,49,72,0.001,70958,POINT (-87.658216 41.939715),60657-20210106
60620,01/11/2021,26,672,10,584,0.009,16,88,0.001,67711,POINT (-87.651656 41.740873),60620-20210111
60659,01/31/2021,41,2742,24,2183,0.051,17,559,0.013,42735,POINT (-87.703266 41.990803),60659-20210131
60612,12/20/2020,12,221,12,221,0.007,0,0,0,33735,POINT (-87.687011 41.88004),60612-20201220
60633,01/20/2021,21,187,16,150,0.012,5,37,0.003,12689,POINT (-87.556037 41.653147),60633-20210120
60614,12/24/2020,30,1282,30,1282,0.018,0,0,0,71954,POINT (-87.652064 41.922605),60614-20201224
60659,02/01/2021,104,2846,71,2254,0.053,33,592,0.014,42735,POINT (-87.703266 41.990803),60659-20210201
60601,01/08/2021,85,658,23,546,0.036,62,112,0.007,15083,POINT (-87.622844 41.886262),60601-20210108
60616,12/28/2020,55,713,55,713,0.013,0,0,0,54197,POINT (-87.629531 41.844869),60616-20201228
60653,12/31/2020,9,399,9,399,0.012,0,0,0,33154,POINT (-87.611244 41.819261),60653-20201231
Unknown,12/16/2020,0,0,0,0,0,0,0,0,0,,Unknown-20201216
60617,01/06/2021,56,526,50,515,0.006,6,11,0,83553,POINT (-87.556897 41.721257),60617-20210106
60626,12/28/2020,24,363,24,363,0.007,0,0,0,50544,POINT (-87.669834 42.009469),60626-20201228
60659,02/02/2021,128,2974,92,2346,0.055,36,628,0.015,42735,POINT (-87.703266 41.990803),60659-20210202
60633,01/10/2021,1,99,1,88,0.007,0,11,0.001,12689,POINT (-87.556037 41.653147),60633-20210110
60632,12/30/2020,131,373,131,373,0.004,0,0,0,89857,POINT (-87.711251 41.810038),60632-20201230
60827,01/02/2021,0,9,0,9,0,0,0,0,28483,POINT (-87.633087 41.650765),60827-20210102
60626,01/07/2021,102,1190,77,1145,0.023,25,45,0.001,50544,POINT (-87.669834 42.009469),60626-20210107
60632,12/16/2020,3,3,3,3,0,0,0,0,89857,POINT (-87.711251 41.810038),60632-20201216
60649,12/21/2020,14,63,14,63,0.001,0,0,0,46633,POINT (-87.571522 41.762202),60649-20201221
60626,12/16/2020,1,1,1,1,0,0,0,0,50544,POINT (-87.669834 42.009469),60626-20201216
60656,01/01/2021,0,284,0,284,0.01,0,0,0,28218,POINT (-87.817934 41.974566),60656-20210101
60660,12/25/2020,0,342,0,342,0.008,0,0,0,44498,POINT (-87.666362 41.991062),60660-20201225
60640,01/16/2021,81,4050,67,3331,0.048,14,719,0.01,69363,POINT (-87.662232 41.971888),60640-20210116
60640,01/21/2021,485,5186,428,4188,0.06,57,998,0.014,69363,POINT (-87.662232 41.971888),60640-20210121
60624,12/18/2020,9,18,9,18,0.001,0,0,0,34892,POINT (-87.722735 41.879417),60624-20201218
60606,12/15/2020,0,0,0,0,0,0,0,0,3287,POINT (-87.63676 41.882634),60606-20201215
Unknown,01/17/2021,1,380,1,339,0,0,41,0,0,,Unknown-20210117
60622,12/30/2020,293,1990,293,1990,0.037,0,0,0,53294,POINT (-87.681818 41.902762),60622-20201230
60630,12/26/2020,9,434,9,434,0.008,0,0,0,56433,POINT (-87.759611 41.971261),60630-20201226
60636,01/08/2021,23,164,17,153,0.005,6,11,0,30024,POINT (-87.668597 41.77599),60636-20210108
60622,01/06/2021,193,2576,172,2533,0.048,21,43,0.001,53294,POINT (-87.681818 41.902762),60622-20210106
60628,01/23/2021,58,1312,58,1122,0.017,0,190,0.003,64254,POINT (-87.621537 41.694192),60628-20210123
60620,12/27/2020,0,135,0,135,0.002,0,0,0,67711,POINT (-87.651656 41.740873),60620-20201227
60642,01/04/2021,45,760,41,756,0.038,4,4,0,19716,POINT (-87.657821 41.899935),60642-20210104
60624,12/25/2020,0,58,0,58,0.002,0,0,0,34892,POINT (-87.722735 41.879417),60624-20201225
60666,12/28/2020,0,0,0,0,0,0,0,0,0,POINT (-87.896371 41.979511),60666-20201228
60601,01/09/2021,45,703,11,557,0.037,34,146,0.01,15083,POINT (-87.622844 41.886262),60601-20210109
60617,01/15/2021,115,1088,107,896,0.011,8,192,0.002,83553,POINT (-87.556897 41.721257),60617-20210115
60631,01/15/2021,45,1438,40,1111,0.038,5,327,0.011,29529,POINT (-87.813371 41.995019),60631-20210115
60626,01/12/2021,194,1706,158,1454,0.029,36,252,0.005,50544,POINT (-87.669834 42.009469),60626-20210112
60605,12/16/2020,11,11,11,11,0,0,0,0,29060,POINT (-87.623449 41.867824),60605-20201216
Unknown,01/28/2021,82,889,76,764,0,6,125,0,0,,Unknown-20210128
60633,02/08/2021,23,644,18,539,0.042,5,105,0.008,12689,POINT (-87.556037 41.653147),60633-20210208
60607,12/20/2020,31,541,31,541,0.018,0,0,0,29293,POINT (-87.652727 41.876104),60607-20201220
60651,12/28/2020,29,144,29,144,0.002,0,0,0,63492,POINT (-87.741017 41.901964),60651-20201228
60629,01/16/2021,129,1512,119,1248,0.011,10,264,0.002,110029,POINT (-87.711565 41.777061),60629-20210116
60660,01/31/2021,54,4135,31,3350,0.075,23,785,0.018,44498,POINT (-87.666362 41.991062),60660-20210131
60623,12/16/2020,2,2,2,2,0,0,0,0,81283,POINT (-87.717446 41.850321),60623-20201216
60612,01/04/2021,80,895,79,894,0.027,1,1,0,33735,POINT (-87.687011 41.88004),60612-20210104
60655,12/19/2020,53,184,53,184,0.006,0,0,0,28569,POINT (-87.701434 41.696456),60655-20201219
60644,01/14/2021,32,897,24,833,0.018,8,64,0.001,46591,POINT (-87.756863 41.881113),60644-20210114
60655,01/05/2021,36,722,31,716,0.025,5,6,0,28569,POINT (-87.701434 41.696456),60655-20210105
60621,12/22/2020,4,28,4,28,0.001,0,0,0,28018,POINT (-87.638812 41.776931),60621-20201222
60660,02/01/2021,146,4281,112,3462,0.078,34,819,0.018,44498,POINT (-87.666362 41.991062),60660-20210201
60601,12/29/2020,27,366,27,366,0.024,0,0,0,15083,POINT (-87.622844 41.886262),60601-20201229
60639,01/08/2021,90,753,60,687,0.008,30,66,0.001,88204,POINT (-87.75531 41.920609),60639-20210108
60652,01/05/2021,36,470,35,468,0.011,1,2,0,43447,POINT (-87.714238 41.745398),60652-20210105
60630,12/15/2020,0,0,0,0,0,0,0,0,56433,POINT (-87.759611 41.971261),60630-20201215
60623,01/06/2021,128,626,123,620,0.008,5,6,0,81283,POINT (-87.717446 41.850321),60623-20210106
60666,02/13/2021,0,23,0,21,0,0,2,0,0,POINT (-87.896371 41.979511),60666-20210213
60633,12/16/2020,0,0,0,0,0,0,0,0,12689,POINT (-87.556037 41.653147),60633-20201216
60660,02/02/2021,180,4461,119,3581,0.08,61,880,0.02,44498,POINT (-87.666362 41.991062),60660-20210202
60656,12/26/2020,3,197,3,197,0.007,0,0,0,28218,POINT (-87.817934 41.974566),60656-20201226
60645,12/25/2020,0,283,0,283,0.006,0,0,0,47270,POINT (-87.695049 42.008927),60645-20201225
60660,02/03/2021,243,4704,129,3710,0.083,114,994,0.022,44498,POINT (-87.666362 41.991062),60660-20210203
60621,01/02/2021,1,180,1,180,0.006,0,0,0,28018,POINT (-87.638812 41.776931),60621-20210102
60638,01/13/2021,89,1204,60,913,0.016,29,291,0.005,58669,POINT (-87.771902 41.787032),60638-20210113
60638,01/18/2021,55,1454,45,1116,0.019,10,338,0.006,58669,POINT (-87.771902 41.787032),60638-20210118
60612,12/30/2020,97,765,97,765,0.023,0,0,0,33735,POINT (-87.687011 41.88004),60612-20201230
60639,01/19/2021,72,1502,51,1261,0.014,21,241,0.003,88204,POINT (-87.75531 41.920609),60639-20210119
60652,01/22/2021,74,1196,66,957,0.022,8,239,0.006,43447,POINT (-87.714238 41.745398),60652-20210122
60657,12/29/2020,172,1790,172,1790,0.025,0,0,0,70958,POINT (-87.658216 41.939715),60657-20201229
60660,01/13/2021,102,2093,62,1782,0.04,40,311,0.007,44498,POINT (-87.666362 41.991062),60660-20210113
60646,12/18/2020,90,103,90,103,0.004,0,0,0,28569,POINT (-87.761826 41.993931),60646-20201218
60631,12/30/2020,48,455,48,455,0.015,0,0,0,29529,POINT (-87.813371 41.995019),60631-20201230
60645,01/04/2021,157,829,155,827,0.017,2,2,0,47270,POINT (-87.695049 42.008927),60645-20210104
Unknown,01/29/2021,34,923,31,795,0,3,128,0,0,,Unknown-20210129
60661,01/19/2021,36,1123,12,746,0.072,24,377,0.036,10354,POINT (-87.644283 41.882786),60661-20210119
60642,12/20/2020,25,290,25,290,0.015,0,0,0,19716,POINT (-87.657821 41.899935),60642-20201220
60666,01/17/2021,0,1,0,1,0,0,0,0,0,POINT (-87.896371 41.979511),60666-20210117
60661,01/20/2021,47,1170,18,764,0.074,29,406,0.039,10354,POINT (-87.644283 41.882786),60661-20210120
60641,12/27/2020,0,442,0,442,0.006,0,0,0,69880,POINT (-87.746791 41.946682),60641-20201227
60631,12/19/2020,74,182,74,182,0.006,0,0,0,29529,POINT (-87.813371 41.995019),60631-20201219
60661,01/21/2021,55,1225,34,798,0.077,21,427,0.041,10354,POINT (-87.644283 41.882786),60661-20210121
60610,12/26/2020,15,658,15,658,0.016,0,0,0,40548,POINT (-87.63581 41.90455),60610-20201226
60666,01/12/2021,0,0,0,0,0,0,0,0,0,POINT (-87.896371 41.979511),60666-20210112
60707,12/20/2020,4,29,4,29,0.001,0,0,0,43093,POINT (-87.808283 41.921777),60707-20201220
60614,12/21/2020,272,951,272,951,0.013,0,0,0,71954,POINT (-87.652064 41.922605),60614-20201221
60660,02/11/2021,274,6900,146,4968,0.112,128,1932,0.043,44498,POINT (-87.666362 41.991062),60660-20210211
60660,02/12/2021,305,7205,210,5178,0.116,95,2027,0.046,44498,POINT (-87.666362 41.991062),60660-20210212
60606,01/08/2021,30,189,7,153,0.047,23,36,0.011,3287,POINT (-87.63676 41.882634),60606-20210108
Unknown,12/15/2020,0,0,0,0,0,0,0,0,0,,Unknown-20201215
60609,01/14/2021,43,929,39,761,0.012,4,168,0.003,60939,POINT (-87.653382 41.812017),60609-20210114
60606,01/21/2021,24,343,19,224,0.068,5,119,0.036,3287,POINT (-87.63676 41.882634),60606-20210121
60661,01/06/2021,28,565,17,548,0.053,11,17,0.002,10354,POINT (-87.644283 41.882786),60661-20210106
60621,01/17/2021,1,320,1,289,0.01,0,31,0.001,28018,POINT (-87.638812 41.776931),60621-20210117
60637,12/24/2020,35,359,35,359,0.008,0,0,0,47300,POINT (-87.604053 41.780991),60637-20201224
60641,01/18/2021,72,2070,48,1611,0.023,24,459,0.007,69880,POINT (-87.746791 41.946682),60641-20210118
60657,01/09/2021,217,3687,60,2921,0.041,157,766,0.011,70958,POINT (-87.658216 41.939715),60657-20210109
60656,12/31/2020,13,284,13,284,0.01,0,0,0,28218,POINT (-87.817934 41.974566),60656-20201231
60827,01/21/2021,3,45,3,39,0.001,0,6,0,28483,POINT (-87.633087 41.650765),60827-20210121
60643,12/17/2020,26,27,26,27,0.001,0,0,0,48887,POINT (-87.662381 41.700445),60643-20201217
60653,01/01/2021,0,399,0,399,0.012,0,0,0,33154,POINT (-87.611244 41.819261),60653-20210101
60649,01/01/2021,0,308,0,308,0.007,0,0,0,46633,POINT (-87.571522 41.762202),60649-20210101
60617,01/19/2021,127,1313,94,1069,0.013,33,244,0.003,83553,POINT (-87.556897 41.721257),60617-20210119
60827,01/16/2021,2,35,2,30,0.001,0,5,0,28483,POINT (-87.633087 41.650765),60827-20210116
60633,12/23/2020,4,23,4,23,0.002,0,0,0,12689,POINT (-87.556037 41.653147),60633-20201223
60630,01/18/2021,68,1999,40,1549,0.027,28,450,0.008,56433,POINT (-87.759611 41.971261),60630-20210118
Unknown,01/11/2021,7,159,3,146,0,4,13,0,0,,Unknown-20210111
60661,02/01/2021,33,1568,23,1025,0.099,10,543,0.052,10354,POINT (-87.644283 41.882786),60661-20210201
60636,12/29/2020,13,55,13,55,0.002,0,0,0,30024,POINT (-87.668597 41.77599),60636-20201229
60661,02/02/2021,47,1615,23,1048,0.101,24,567,0.055,10354,POINT (-87.644283 41.882786),60661-20210202
60652,01/19/2021,51,965,23,783,0.018,28,182,0.004,43447,POINT (-87.714238 41.745398),60652-20210119
60643,12/26/2020,1,312,1,312,0.006,0,0,0,48887,POINT (-87.662381 41.700445),60643-20201226
60827,12/16/2020,0,0,0,0,0,0,0,0,28483,POINT (-87.633087 41.650765),60827-20201216
60661,02/03/2021,41,1656,27,1075,0.104,14,581,0.056,10354,POINT (-87.644283 41.882786),60661-20210203
60608,12/27/2020,0,571,0,571,0.007,0,0,0,80059,POINT (-87.670366 41.849879),60608-20201227
60645,12/30/2020,152,602,152,602,0.013,0,0,0,47270,POINT (-87.695049 42.008927),60645-20201230
60625,12/24/2020,20,627,20,627,0.008,0,0,0,79444,POINT (-87.701816 41.971155),60625-20201224
60632,12/17/2020,12,15,12,15,0,0,0,0,89857,POINT (-87.711251 41.810038),60632-20201217
60645,12/18/2020,65,86,65,86,0.002,0,0,0,47270,POINT (-87.695049 42.008927),60645-20201218
60640,01/19/2021,158,4382,88,3520,0.051,70,862,0.012,69363,POINT (-87.662232 41.971888),60640-20210119
60653,01/11/2021,34,710,13,605,0.018,21,105,0.003,33154,POINT (-87.611244 41.819261),60653-20210111
60610,01/14/2021,88,2164,67,1528,0.038,21,636,0.016,40548,POINT (-87.63581 41.90455),60610-20210114
60630,12/23/2020,50,414,50,414,0.007,0,0,0,56433,POINT (-87.759611 41.971261),60630-20201223
60645,01/09/2021,39,1309,17,1171,0.025,22,138,0.003,47270,POINT (-87.695049 42.008927),60645-20210109
60660,12/22/2020,45,288,45,288,0.006,0,0,0,44498,POINT (-87.666362 41.991062),60660-20201222
60707,01/21/2021,45,518,39,415,0.01,6,103,0.002,43093,POINT (-87.808283 41.921777),60707-20210121
60628,01/24/2021,31,1343,31,1153,0.018,0,190,0.003,64254,POINT (-87.621537 41.694192),60628-20210124
60666,02/07/2021,0,14,0,14,0,0,0,0,0,POINT (-87.896371 41.979511),60666-20210207
60601,01/04/2021,33,461,31,459,0.03,2,2,0,15083,POINT (-87.622844 41.886262),60601-20210104
60620,01/15/2021,36,874,32,740,0.011,4,134,0.002,67711,POINT (-87.651656 41.740873),60620-20210115
60661,02/13/2021,45,2120,25,1364,0.132,20,756,0.073,10354,POINT (-87.644283 41.882786),60661-20210213
60631,01/18/2021,36,1609,30,1268,0.043,6,341,0.012,29529,POINT (-87.813371 41.995019),60631-20210118
60624,12/22/2020,14,49,14,49,0.001,0,0,0,34892,POINT (-87.722735 41.879417),60624-20201222
60626,12/24/2020,14,337,14,337,0.007,0,0,0,50544,POINT (-87.669834 42.009469),60626-20201224
60616,12/24/2020,32,646,32,646,0.012,0,0,0,54197,POINT (-87.629531 41.844869),60616-20201224
60640,12/20/2020,17,331,17,331,0.005,0,0,0,69363,POINT (-87.662232 41.971888),60640-20201220
60661,02/14/2021,11,2131,9,1373,0.133,2,758,0.073,10354,POINT (-87.644283 41.882786),60661-20210214
60622,12/18/2020,311,449,311,449,0.008,0,0,0,53294,POINT (-87.681818 41.902762),60622-20201218
60607,01/16/2021,51,3282,36,2302,0.079,15,980,0.033,29293,POINT (-87.652727 41.876104),60607-20210116
60618,01/11/2021,218,2837,77,2216,0.023,141,621,0.007,94907,POINT (-87.703343 41.946699),60618-20210111
60622,01/02/2021,36,2125,36,2125,0.04,0,0,0,53294,POINT (-87.681818 41.902762),60622-20210102
60613,12/17/2020,49,56,49,56,0.001,0,0,0,50761,POINT (-87.661343 41.953742),60613-20201217
60629,12/28/2020,33,320,33,320,0.003,0,0,0,110029,POINT (-87.711565 41.777061),60629-20201228
60655,12/31/2020,31,529,31,529,0.019,0,0,0,28569,POINT (-87.701434 41.696456),60655-20201231
60653,12/27/2020,0,169,0,169,0.005,0,0,0,33154,POINT (-87.611244 41.819261),60653-20201227
60625,01/16/2021,83,2954,75,2341,0.029,8,613,0.008,79444,POINT (-87.701816 41.971155),60625-20210116
60630,01/07/2021,115,1105,56,1022,0.018,59,83,0.001,56433,POINT (-87.759611 41.971261),60630-20210107
60644,12/26/2020,3,85,3,85,0.002,0,0,0,46591,POINT (-87.756863 41.881113),60644-20201226
60606,12/20/2020,3,52,3,52,0.016,0,0,0,3287,POINT (-87.63676 41.882634),60606-20201220
60660,12/29/2020,58,441,58,441,0.01,0,0,0,44498,POINT (-87.666362 41.991062),60660-20201229
60642,01/08/2021,146,1091,29,886,0.045,117,205,0.01,19716,POINT (-87.657821 41.899935),60642-20210108
60707,12/24/2020,4,75,4,75,0.002,0,0,0,43093,POINT (-87.808283 41.921777),60707-20201224
60632,12/26/2020,6,160,6,160,0.002,0,0,0,89857,POINT (-87.711251 41.810038),60632-20201226
60656,02/01/2021,69,1640,52,1280,0.045,17,360,0.013,28218,POINT (-87.817934 41.974566),60656-20210201
60827,01/06/2021,2,13,2,13,0,0,0,0,28483,POINT (-87.633087 41.650765),60827-20210106
60652,12/21/2020,30,93,30,93,0.002,0,0,0,43447,POINT (-87.714238 41.745398),60652-20201221
60633,01/24/2021,6,253,5,205,0.016,1,48,0.004,12689,POINT (-87.556037 41.653147),60633-20210124
60608,12/15/2020,0,0,0,0,0,0,0,0,80059,POINT (-87.670366 41.849879),60608-20201215
60624,01/06/2021,18,186,17,185,0.005,1,1,0,34892,POINT (-87.722735 41.879417),60624-20210106
60827,02/03/2021,8,99,6,82,0.003,2,17,0.001,28483,POINT (-87.633087 41.650765),60827-20210203
60827,02/07/2021,3,119,3,99,0.003,0,20,0.001,28483,POINT (-87.633087 41.650765),60827-20210207
60827,02/10/2021,6,133,4,109,0.004,2,24,0.001,28483,POINT (-87.633087 41.650765),60827-20210210
60827,02/11/2021,4,137,3,112,0.004,1,25,0.001,28483,POINT (-87.633087 41.650765),60827-20210211
60827,02/12/2021,5,142,3,115,0.004,2,27,0.001,28483,POINT (-87.633087 41.650765),60827-20210212
60655,01/15/2021,47,1445,39,1080,0.038,8,365,0.013,28569,POINT (-87.701434 41.696456),60655-20210115
60666,01/02/2021,0,0,0,0,0,0,0,0,0,POINT (-87.896371 41.979511),60666-20210102
60827,02/13/2021,4,146,2,117,0.004,2,29,0.001,28483,POINT (-87.633087 41.650765),60827-20210213
60602,12/29/2020,5,39,5,39,0.034,0,0,0,1145,POINT (-87.628309 41.883136),60602-20201229
60631,01/03/2021,9,613,9,613,0.021,0,0,0,29529,POINT (-87.813371 41.995019),60631-20210103
60827,02/15/2021,2,148,0,117,0.004,2,31,0.001,28483,POINT (-87.633087 41.650765),60827-20210215
60827,02/16/2021,2,150,0,117,0.004,2,33,0.001,28483,POINT (-87.633087 41.650765),60827-20210216
60608,01/11/2021,121,1848,34,1518,0.019,87,330,0.004,80059,POINT (-87.670366 41.849879),60608-20210111
60640,01/04/2021,198,1524,191,1517,0.022,7,7,0,69363,POINT (-87.662232 41.971888),60640-20210104
60827,02/17/2021,7,157,4,121,0.004,3,36,0.001,28483,POINT (-87.633087 41.650765),60827-20210217
60618,12/27/2020,0,942,0,942,0.01,0,0,0,94907,POINT (-87.703343 41.946699),60618-20201227
60605,12/20/2020,74,640,74,640,0.022,0,0,0,29060,POINT (-87.623449 41.867824),60605-20201220
60620,12/31/2020,12,257,12,257,0.004,0,0,0,67711,POINT (-87.651656 41.740873),60620-20201231
60656,12/19/2020,37,105,37,105,0.004,0,0,0,28218,POINT (-87.817934 41.974566),60656-20201219
Unknown,02/12/2021,41,1519,18,1045,0,23,474,0,0,,Unknown-20210212
Unknown,02/13/2021,41,1560,19,1064,0,22,496,0,0,,Unknown-20210213
60601,01/13/2021,50,905,28,627,0.042,22,278,0.018,15083,POINT (-87.622844 41.886262),60601-20210113
Unknown,02/14/2021,6,1566,5,1069,0,1,497,0,0,,Unknown-20210214
Unknown,12/27/2020,0,41,0,41,0,0,0,0,0,,Unknown-20201227
60641,01/08/2021,147,1230,65,1061,0.015,82,169,0.002,69880,POINT (-87.746791 41.946682),60641-20210108
60633,01/07/2021,15,90,6,80,0.006,9,10,0.001,12689,POINT (-87.556037 41.653147),60633-20210107
60637,12/17/2020,24,26,24,26,0.001,0,0,0,47300,POINT (-87.604053 41.780991),60637-20201217
Unknown,02/15/2021,15,1581,11,1080,0,4,501,0,0,,Unknown-20210215
Unknown,02/16/2021,10,1591,7,1087,0,3,504,0,0,,Unknown-20210216
60624,01/01/2021,0,118,0,118,0.003,0,0,0,34892,POINT (-87.722735 41.879417),60624-20210101
60623,12/22/2020,26,113,26,113,0.001,0,0,0,81283,POINT (-87.717446 41.850321),60623-20201222
60651,12/21/2020,19,69,19,69,0.001,0,0,0,63492,POINT (-87.741017 41.901964),60651-20201221
Unknown,02/17/2021,60,1651,20,1107,0,40,544,0,0,,Unknown-20210217
60632,01/10/2021,8,695,1,640,0.007,7,55,0.001,89857,POINT (-87.711251 41.810038),60632-20210110
60661,12/19/2020,61,197,61,197,0.019,0,0,0,10354,POINT (-87.644283 41.882786),60661-20201219
60621,01/06/2021,14,219,11,214,0.008,3,5,0,28018,POINT (-87.638812 41.776931),60621-20210106
60628,12/15/2020,0,0,0,0,0,0,0,0,64254,POINT (-87.621537 41.694192),60628-20201215
60639,01/04/2021,66,477,63,474,0.005,3,3,0,88204,POINT (-87.75531 41.920609),60639-20210104
60633,01/27/2021,31,323,27,260,0.02,4,63,0.005,12689,POINT (-87.556037 41.653147),60633-20210127
60644,01/10/2021,7,656,4,628,0.013,3,28,0.001,46591,POINT (-87.756863 41.881113),60644-20210110
60653,12/18/2020,27,37,27,37,0.001,0,0,0,33154,POINT (-87.611244 41.819261),60653-20201218
60630,01/03/2021,7,680,7,680,0.012,0,0,0,56433,POINT (-87.759611 41.971261),60630-20210103
60666,02/18/2021,1,25,1,23,0,0,2,0,0,POINT (-87.896371 41.979511),60666-20210218
60610,12/30/2020,97,875,97,875,0.022,0,0,0,40548,POINT (-87.63581 41.90455),60610-20201230
60601,02/18/2021,99,3078,40,2078,0.138,59,1000,0.066,15083,POINT (-87.622844 41.886262),60601-20210218
60827,12/27/2020,0,7,0,7,0,0,0,0,28483,POINT (-87.633087 41.650765),60827-20201227
60656,01/15/2021,24,740,20,540,0.019,4,200,0.007,28218,POINT (-87.817934 41.974566),60656-20210115
60617,12/31/2020,19,362,19,362,0.004,0,0,0,83553,POINT (-87.556897 41.721257),60617-20201231
60618,01/05/2021,151,1789,145,1771,0.019,6,18,0,94907,POINT (-87.703343 41.946699),60618-20210105
60649,12/28/2020,21,142,21,142,0.003,0,0,0,46633,POINT (-87.571522 41.762202),60649-20201228
60606,12/16/2020,0,0,0,0,0,0,0,0,3287,POINT (-87.63676 41.882634),60606-20201216
60707,01/06/2021,10,154,9,152,0.004,1,2,0,43093,POINT (-87.808283 41.921777),60707-20210106
60638,01/03/2021,9,576,9,576,0.01,0,0,0,58669,POINT (-87.771902 41.787032),60638-20210103
60602,02/18/2021,16,514,5,353,0.308,11,161,0.141,1145,POINT (-87.628309 41.883136),60602-20210218
60623,12/25/2020,0,155,0,155,0.002,0,0,0,81283,POINT (-87.717446 41.850321),60623-20201225
60641,01/03/2021,18,710,18,710,0.01,0,0,0,69880,POINT (-87.746791 41.946682),60641-20210103
60661,12/22/2020,43,313,43,313,0.03,0,0,0,10354,POINT (-87.644283 41.882786),60661-20201222
60660,01/01/2021,1,590,1,590,0.013,0,0,0,44498,POINT (-87.666362 41.991062),60660-20210101
60633,02/03/2021,32,493,30,413,0.033,2,80,0.006,12689,POINT (-87.556037 41.653147),60633-20210203
60649,12/15/2020,0,0,0,0,0,0,0,0,46633,POINT (-87.571522 41.762202),60649-20201215
60628,01/02/2021,3,235,3,235,0.004,0,0,0,64254,POINT (-87.621537 41.694192),60628-20210102
60653,01/05/2021,29,459,26,455,0.014,3,4,0,33154,POINT (-87.611244 41.819261),60653-20210105
60614,12/17/2020,128,132,128,132,0.002,0,0,0,71954,POINT (-87.652064 41.922605),60614-20201217
60631,12/17/2020,20,23,20,23,0.001,0,0,0,29529,POINT (-87.813371 41.995019),60631-20201217
60661,12/20/2020,17,214,17,214,0.021,0,0,0,10354,POINT (-87.644283 41.882786),60661-20201220
60631,12/23/2020,24,335,24,335,0.011,0,0,0,29529,POINT (-87.813371 41.995019),60631-20201223
60636,12/25/2020,0,30,0,30,0.001,0,0,0,30024,POINT (-87.668597 41.77599),60636-20201225
60666,01/21/2021,0,2,0,2,0,0,0,0,0,POINT (-87.896371 41.979511),60666-20210121
60609,12/17/2020,9,9,9,9,0,0,0,0,60939,POINT (-87.653382 41.812017),60609-20201217
60606,01/12/2021,19,247,4,165,0.05,15,82,0.025,3287,POINT (-87.63676 41.882634),60606-20210112
60603,02/18/2021,8,530,5,400,0.38,3,130,0.124,1052,POINT (-87.625473 41.880112),60603-20210218
60638,12/29/2020,73,430,73,430,0.007,0,0,0,58669,POINT (-87.771902 41.787032),60638-20201229
60628,12/28/2020,31,143,31,143,0.002,0,0,0,64254,POINT (-87.621537 41.694192),60628-20201228
60604,02/18/2021,7,323,3,252,0.306,4,71,0.086,823,POINT (-87.629029 41.878153),60604-20210218
60656,01/10/2021,13,542,6,418,0.015,7,124,0.004,28218,POINT (-87.817934 41.974566),60656-20210110
60602,01/04/2021,3,50,3,50,0.044,0,0,0,1145,POINT (-87.628309 41.883136),60602-20210104
60656,01/20/2021,66,900,53,668,0.024,13,232,0.008,28218,POINT (-87.817934 41.974566),60656-20210120
60608,02/18/2021,321,11071,172,8260,0.103,149,2811,0.035,80059,POINT (-87.670366 41.849879),60608-20210218
60606,01/17/2021,2,279,2,189,0.057,0,90,0.027,3287,POINT (-87.63676 41.882634),60606-20210117
60639,01/15/2021,67,1306,66,1105,0.013,1,201,0.002,88204,POINT (-87.75531 41.920609),60639-20210115
60616,12/21/2020,93,432,93,432,0.008,0,0,0,54197,POINT (-87.629531 41.844869),60616-20201221
60605,02/18/2021,175,7971,65,5106,0.176,110,2865,0.099,29060,POINT (-87.623449 41.867824),60605-20210218
60621,12/18/2020,4,9,4,9,0,0,0,0,28018,POINT (-87.638812 41.776931),60621-20201218
60617,01/11/2021,65,757,29,640,0.008,36,117,0.001,83553,POINT (-87.556897 41.721257),60617-20210111
60608,01/16/2021,57,2463,52,1935,0.024,5,528,0.007,80059,POINT (-87.670366 41.849879),60608-20210116
60619,01/15/2021,42,872,38,764,0.012,4,108,0.002,61207,POINT (-87.60569 41.744737),60619-20210115
60633,01/17/2021,0,137,0,112,0.009,0,25,0.002,12689,POINT (-87.556037 41.653147),60633-20210117
60609,02/18/2021,216,5817,110,4476,0.073,106,1341,0.022,60939,POINT (-87.653382 41.812017),60609-20210218
60610,01/10/2021,30,1700,11,1320,0.033,19,380,0.009,40548,POINT (-87.63581 41.90455),60610-20210110
60619,01/01/2021,0,267,0,267,0.004,0,0,0,61207,POINT (-87.60569 41.744737),60619-20210101
60607,12/28/2020,52,1061,52,1061,0.036,0,0,0,29293,POINT (-87.652727 41.876104),60607-20201228
60641,12/20/2020,15,215,15,215,0.003,0,0,0,69880,POINT (-87.746791 41.946682),60641-20201220
60661,01/01/2021,0,461,0,461,0.045,0,0,0,10354,POINT (-87.644283 41.882786),60661-20210101
60632,12/23/2020,25,143,25,143,0.002,0,0,0,89857,POINT (-87.711251 41.810038),60632-20201223
60612,02/18/2021,259,6037,145,4081,0.121,114,1956,0.058,33735,POINT (-87.687011 41.88004),60612-20210218
60827,01/11/2021,1,20,1,18,0.001,0,2,0,28483,POINT (-87.633087 41.650765),60827-20210111
60616,02/18/2021,307,8996,127,6427,0.119,180,2569,0.047,54197,POINT (-87.629531 41.844869),60616-20210218
60617,02/18/2021,398,8381,176,6291,0.075,222,2090,0.025,83553,POINT (-87.556897 41.721257),60617-20210218
60618,01/15/2021,135,3590,121,2703,0.028,14,887,0.009,94907,POINT (-87.703343 41.946699),60618-20210115
60637,12/29/2020,73,450,73,450,0.01,0,0,0,47300,POINT (-87.604053 41.780991),60637-20201229
60626,01/06/2021,88,1088,71,1068,0.021,17,20,0,50544,POINT (-87.669834 42.009469),60626-20210106
60612,01/14/2021,100,1796,65,1308,0.039,35,488,0.014,33735,POINT (-87.687011 41.88004),60612-20210114
60827,12/15/2020,0,0,0,0,0,0,0,0,28483,POINT (-87.633087 41.650765),60827-20201215
60642,01/11/2021,76,1300,20,942,0.048,56,358,0.018,19716,POINT (-87.657821 41.899935),60642-20210111
60642,01/18/2021,48,1695,23,1154,0.059,25,541,0.027,19716,POINT (-87.657821 41.899935),60642-20210118
60657,01/17/2021,290,5534,257,4064,0.057,33,1470,0.021,70958,POINT (-87.658216 41.939715),60657-20210117
60631,01/14/2021,54,1393,45,1071,0.036,9,322,0.011,29529,POINT (-87.813371 41.995019),60631-20210114
Unknown,01/16/2021,33,379,29,338,0,4,41,0,0,,Unknown-20210116
60630,12/19/2020,81,210,81,210,0.004,0,0,0,56433,POINT (-87.759611 41.971261),60630-20201219
60652,01/12/2021,54,704,30,600,0.014,24,104,0.002,43447,POINT (-87.714238 41.745398),60652-20210112
60608,12/20/2020,19,244,19,244,0.003,0,0,0,80059,POINT (-87.670366 41.849879),60608-20201220
60640,12/18/2020,174,218,174,218,0.003,0,0,0,69363,POINT (-87.662232 41.971888),60640-20201218
60607,12/27/2020,0,1009,0,1009,0.034,0,0,0,29293,POINT (-87.652727 41.876104),60607-20201227
60707,01/12/2021,27,252,18,208,0.005,9,44,0.001,43093,POINT (-87.808283 41.921777),60707-20210112
60636,01/09/2021,7,171,5,158,0.005,2,13,0,30024,POINT (-87.668597 41.77599),60636-20210109
60602,01/09/2021,4,77,0,63,0.055,4,14,0.012,1145,POINT (-87.628309 41.883136),60602-20210109
60622,12/22/2020,198,1211,198,1211,0.023,0,0,0,53294,POINT (-87.681818 41.902762),60622-20201222
60633,01/02/2021,5,53,5,53,0.004,0,0,0,12689,POINT (-87.556037 41.653147),60633-20210102
60827,01/28/2021,8,69,6,59,0.002,2,10,0,28483,POINT (-87.633087 41.650765),60827-20210128
60607,01/11/2021,150,2611,29,1953,0.067,121,658,0.022,29293,POINT (-87.652727 41.876104),60607-20210111
60623,01/09/2021,35,775,27,730,0.009,8,45,0.001,81283,POINT (-87.717446 41.850321),60623-20210109
60638,12/17/2020,22,22,22,22,0,0,0,0,58669,POINT (-87.771902 41.787032),60638-20201217
60622,12/16/2020,3,3,3,3,0,0,0,0,53294,POINT (-87.681818 41.902762),60622-20201216
60655,12/26/2020,5,379,5,379,0.013,0,0,0,28569,POINT (-87.701434 41.696456),60655-20201226
60655,01/10/2021,25,1051,3,807,0.028,22,244,0.009,28569,POINT (-87.701434 41.696456),60655-20210110
60644,12/30/2020,32,205,32,205,0.004,0,0,0,46591,POINT (-87.756863 41.881113),60644-20201230
60632,01/07/2021,58,604,41,579,0.006,17,25,0,89857,POINT (-87.711251 41.810038),60632-20210107
60601,12/16/2020,2,2,2,2,0,0,0,0,15083,POINT (-87.622844 41.886262),60601-20201216
60626,12/15/2020,0,0,0,0,0,0,0,0,50544,POINT (-87.669834 42.009469),60626-20201215
60666,12/19/2020,0,0,0,0,0,0,0,0,0,POINT (-87.896371 41.979511),60666-20201219
60618,12/31/2020,80,1411,80,1411,0.015,0,0,0,94907,POINT (-87.703343 41.946699),60618-20201231
60628,01/17/2021,4,770,1,664,0.01,3,106,0.002,64254,POINT (-87.621537 41.694192),60628-20210117
60620,01/10/2021,9,646,2,574,0.008,7,72,0.001,67711,POINT (-87.651656 41.740873),60620-20210110
60605,12/24/2020,42,1208,42,1208,0.042,0,0,0,29060,POINT (-87.623449 41.867824),60605-20201224
60666,01/06/2021,0,0,0,0,0,0,0,0,0,POINT (-87.896371 41.979511),60666-20210106
60640,01/08/2021,500,2621,360,2372,0.034,140,249,0.004,69363,POINT (-87.662232 41.971888),60640-20210108
60609,12/30/2020,64,307,64,307,0.005,0,0,0,60939,POINT (-87.653382 41.812017),60609-20201230
60602,12/25/2020,0,30,0,30,0.026,0,0,0,1145,POINT (-87.628309 41.883136),60602-20201225
60645,01/14/2021,76,1716,65,1454,0.031,11,262,0.006,47270,POINT (-87.695049 42.008927),60645-20210114
60637,01/13/2021,79,1406,50,1082,0.023,29,324,0.007,47300,POINT (-87.604053 41.780991),60637-20210113
60625,01/12/2021,176,2460,121,1981,0.025,55,479,0.006,79444,POINT (-87.701816 41.971155),60625-20210112
60628,01/16/2021,17,766,15,663,0.01,2,103,0.002,64254,POINT (-87.621537 41.694192),60628-20210116
60643,01/10/2021,10,926,2,749,0.015,8,177,0.004,48887,POINT (-87.662381 41.700445),60643-20210110
60653,01/09/2021,74,663,56,589,0.018,18,74,0.002,33154,POINT (-87.611244 41.819261),60653-20210109
60651,12/25/2020,0,112,0,112,0.002,0,0,0,63492,POINT (-87.741017 41.901964),60651-20201225
60655,01/13/2021,124,1307,105,964,0.034,19,343,0.012,28569,POINT (-87.701434 41.696456),60655-20210113
60649,12/19/2020,7,47,7,47,0.001,0,0,0,46633,POINT (-87.571522 41.762202),60649-20201219
60631,12/22/2020,30,311,30,311,0.011,0,0,0,29529,POINT (-87.813371 41.995019),60631-20201222
60626,12/19/2020,58,162,58,162,0.003,0,0,0,50544,POINT (-87.669834 42.009469),60626-20201219
60633,01/11/2021,7,106,2,90,0.007,5,16,0.001,12689,POINT (-87.556037 41.653147),60633-20210111
60652,12/18/2020,27,40,27,40,0.001,0,0,0,43447,POINT (-87.714238 41.745398),60652-20201218
60608,12/19/2020,72,225,72,225,0.003,0,0,0,80059,POINT (-87.670366 41.849879),60608-20201219
60601,12/21/2020,73,221,73,221,0.015,0,0,0,15083,POINT (-87.622844 41.886262),60601-20201221
60660,12/18/2020,93,123,93,123,0.003,0,0,0,44498,POINT (-87.666362 41.991062),60660-20201218
60609,12/15/2020,0,0,0,0,0,0,0,0,60939,POINT (-87.653382 41.812017),60609-20201215
60609,01/18/2021,53,1110,33,903,0.015,20,207,0.003,60939,POINT (-87.653382 41.812017),60609-20210118
60623,01/14/2021,57,1067,49,930,0.011,8,137,0.002,81283,POINT (-87.717446 41.850321),60623-20210114
60666,12/22/2020,0,0,0,0,0,0,0,0,0,POINT (-87.896371 41.979511),60666-20201222
60656,01/23/2021,42,1065,37,814,0.029,5,251,0.009,28218,POINT (-87.817934 41.974566),60656-20210123
60656,02/07/2021,29,2235,28,1774,0.063,1,461,0.016,28218,POINT (-87.817934 41.974566),60656-20210207
60637,01/12/2021,61,1327,24,1032,0.022,37,295,0.006,47300,POINT (-87.604053 41.780991),60637-20210112
60649,01/14/2021,48,958,41,856,0.018,7,102,0.002,46633,POINT (-87.571522 41.762202),60649-20210114
60656,01/21/2021,66,966,54,722,0.026,12,244,0.009,28218,POINT (-87.817934 41.974566),60656-20210121
60609,01/01/2021,0,336,0,336,0.006,0,0,0,60939,POINT (-87.653382 41.812017),60609-20210101
60628,01/11/2021,23,583,11,522,0.008,12,61,0.001,64254,POINT (-87.621537 41.694192),60628-20210111
60643,12/29/2020,44,374,44,374,0.008,0,0,0,48887,POINT (-87.662381 41.700445),60643-20201229
60827,12/23/2020,0,6,0,6,0,0,0,0,28483,POINT (-87.633087 41.650765),60827-20201223
60656,12/16/2020,1,1,1,1,0,0,0,0,28218,POINT (-87.817934 41.974566),60656-20201216
60644,01/06/2021,34,579,32,577,0.012,2,2,0,46591,POINT (-87.756863 41.881113),60644-20210106
60602,01/05/2021,8,58,7,57,0.05,1,1,0.001,1145,POINT (-87.628309 41.883136),60602-20210105
60621,01/10/2021,1,259,1,243,0.009,0,16,0.001,28018,POINT (-87.638812 41.776931),60621-20210110
60661,12/26/2020,8,359,8,359,0.035,0,0,0,10354,POINT (-87.644283 41.882786),60661-20201226
60666,02/04/2021,1,14,1,14,0,0,0,0,0,POINT (-87.896371 41.979511),60666-20210204
60619,12/16/2020,0,0,0,0,0,0,0,0,61207,POINT (-87.60569 41.744737),60619-20201216
60636,12/21/2020,8,17,8,17,0.001,0,0,0,30024,POINT (-87.668597 41.77599),60636-20201221
60617,01/17/2021,5,1122,4,924,0.011,1,198,0.002,83553,POINT (-87.556897 41.721257),60617-20210117
60649,01/09/2021,18,609,11,561,0.012,7,48,0.001,46633,POINT (-87.571522 41.762202),60649-20210109
60827,02/08/2021,5,124,4,103,0.004,1,21,0.001,28483,POINT (-87.633087 41.650765),60827-20210208
60621,01/15/2021,4,311,4,282,0.01,0,29,0.001,28018,POINT (-87.638812 41.776931),60621-20210115
60609,01/06/2021,133,545,127,536,0.009,6,9,0,60939,POINT (-87.653382 41.812017),60609-20210106
60639,12/18/2020,41,51,41,51,0.001,0,0,0,88204,POINT (-87.75531 41.920609),60639-20201218
60644,01/01/2021,0,213,0,213,0.005,0,0,0,46591,POINT (-87.756863 41.881113),60644-20210101
60629,12/23/2020,46,261,46,261,0.002,0,0,0,110029,POINT (-87.711565 41.777061),60629-20201223
60642,12/15/2020,0,0,0,0,0,0,0,0,19716,POINT (-87.657821 41.899935),60642-20201215
60612,12/25/2020,0,523,0,523,0.016,0,0,0,33735,POINT (-87.687011 41.88004),60612-20201225
60631,12/27/2020,0,347,0,347,0.012,0,0,0,29529,POINT (-87.813371 41.995019),60631-20201227
60640,12/29/2020,104,929,104,929,0.013,0,0,0,69363,POINT (-87.662232 41.971888),60640-20201229
60661,01/14/2021,33,1006,22,674,0.065,11,332,0.032,10354,POINT (-87.644283 41.882786),60661-20210114
60633,12/31/2020,3,48,3,48,0.004,0,0,0,12689,POINT (-87.556037 41.653147),60633-20201231
Unknown,01/03/2021,2,90,2,90,0,0,0,0,0,,Unknown-20210103
60617,01/07/2021,57,583,33,548,0.007,24,35,0,83553,POINT (-87.556897 41.721257),60617-20210107
60629,12/17/2020,17,19,17,19,0,0,0,0,110029,POINT (-87.711565 41.777061),60629-20201217
60652,01/13/2021,78,782,54,654,0.015,24,128,0.003,43447,POINT (-87.714238 41.745398),60652-20210113
60707,01/15/2021,16,314,14,249,0.006,2,65,0.002,43093,POINT (-87.808283 41.921777),60707-20210115
60619,12/26/2020,0,121,0,121,0.002,0,0,0,61207,POINT (-87.60569 41.744737),60619-20201226
60641,12/24/2020,22,429,22,429,0.006,0,0,0,69880,POINT (-87.746791 41.946682),60641-20201224
60640,01/25/2021,204,5819,148,4724,0.068,56,1095,0.016,69363,POINT (-87.662232 41.971888),60640-20210125
60606,12/29/2020,5,102,5,102,0.031,0,0,0,3287,POINT (-87.63676 41.882634),60606-20201229
60827,01/07/2021,2,15,2,15,0.001,0,0,0,28483,POINT (-87.633087 41.650765),60827-20210107
60645,01/01/2021,0,646,0,646,0.014,0,0,0,47270,POINT (-87.695049 42.008927),60645-20210101
60638,01/08/2021,94,882,34,763,0.013,60,119,0.002,58669,POINT (-87.771902 41.787032),60638-20210108
60643,01/13/2021,327,1416,296,1130,0.023,31,286,0.006,48887,POINT (-87.662381 41.700445),60643-20210113
60620,12/22/2020,25,107,25,107,0.002,0,0,0,67711,POINT (-87.651656 41.740873),60620-20201222
60618,12/18/2020,217,277,217,277,0.003,0,0,0,94907,POINT (-87.703343 41.946699),60618-20201218
Unknown,02/04/2021,66,1131,33,905,0,33,226,0,0,,Unknown-20210204
60643,12/15/2020,0,0,0,0,0,0,0,0,48887,POINT (-87.662381 41.700445),60643-20201215
60638,12/24/2020,11,322,11,322,0.005,0,0,0,58669,POINT (-87.771902 41.787032),60638-20201224
60666,01/03/2021,0,0,0,0,0,0,0,0,0,POINT (-87.896371 41.979511),60666-20210103
60617,01/02/2021,5,368,5,368,0.004,0,0,0,83553,POINT (-87.556897 41.721257),60617-20210102
60622,12/26/2020,16,1376,16,1376,0.026,0,0,0,53294,POINT (-87.681818 41.902762),60622-20201226
60605,12/19/2020,165,566,165,566,0.019,0,0,0,29060,POINT (-87.623449 41.867824),60605-20201219
60625,01/18/2021,120,3119,81,2453,0.031,39,666,0.008,79444,POINT (-87.701816 41.971155),60625-20210118
60610,01/06/2021,67,1184,55,1155,0.028,12,29,0.001,40548,POINT (-87.63581 41.90455),60610-20210106
60606,01/13/2021,8,255,3,168,0.051,5,87,0.026,3287,POINT (-87.63676 41.882634),60606-20210113
60630,01/16/2021,68,1911,62,1496,0.027,6,415,0.007,56433,POINT (-87.759611 41.971261),60630-20210116
60619,01/06/2021,42,391,39,384,0.006,3,7,0,61207,POINT (-87.60569 41.744737),60619-20210106
60601,01/12/2021,73,855,27,599,0.04,46,256,0.017,15083,POINT (-87.622844 41.886262),60601-20210112
60628,12/27/2020,0,112,0,112,0.002,0,0,0,64254,POINT (-87.621537 41.694192),60628-20201227
60636,01/05/2021,12,111,11,110,0.004,1,1,0,30024,POINT (-87.668597 41.77599),60636-20210105
60618,01/19/2021,195,4093,100,3012,0.032,95,1081,0.011,94907,POINT (-87.703343 41.946699),60618-20210119
60620,12/16/2020,0,0,0,0,0,0,0,0,67711,POINT (-87.651656 41.740873),60620-20201216
60655,01/23/2021,82,2013,73,1576,0.055,9,437,0.015,28569,POINT (-87.701434 41.696456),60655-20210123
60652,12/29/2020,53,307,53,307,0.007,0,0,0,43447,POINT (-87.714238 41.745398),60652-20201229
60655,01/17/2021,13,1479,13,1108,0.039,0,371,0.013,28569,POINT (-87.701434 41.696456),60655-20210117
60629,01/07/2021,75,778,46,740,0.007,29,38,0,110029,POINT (-87.711565 41.777061),60629-20210107
60628,12/17/2020,7,7,7,7,0,0,0,0,64254,POINT (-87.621537 41.694192),60628-20201217
60607,12/23/2020,108,953,108,953,0.033,0,0,0,29293,POINT (-87.652727 41.876104),60607-20201223
60624,12/30/2020,21,102,21,102,0.003,0,0,0,34892,POINT (-87.722735 41.879417),60624-20201230
60666,01/10/2021,0,0,0,0,0,0,0,0,0,POINT (-87.896371 41.979511),60666-20210110
60602,12/21/2020,5,20,5,20,0.017,0,0,0,1145,POINT (-87.628309 41.883136),60602-20201221
60827,01/14/2021,3,30,2,25,0.001,1,5,0,28483,POINT (-87.633087 41.650765),60827-20210114
60827,01/24/2021,0,48,0,42,0.001,0,6,0,28483,POINT (-87.633087 41.650765),60827-20210124
60607,01/07/2021,214,1985,92,1816,0.062,122,169,0.006,29293,POINT (-87.652727 41.876104),60607-20210107
60633,02/01/2021,12,428,12,355,0.028,0,73,0.006,12689,POINT (-87.556037 41.653147),60633-20210201
60601,01/05/2021,36,497,34,493,0.033,2,4,0,15083,POINT (-87.622844 41.886262),60601-20210105
Unknown,01/24/2021,1,692,1,606,0,0,86,0,0,,Unknown-20210124
60626,01/03/2021,19,778,18,777,0.015,1,1,0,50544,POINT (-87.669834 42.009469),60626-20210103
60655,12/22/2020,46,344,46,344,0.012,0,0,0,28569,POINT (-87.701434 41.696456),60655-20201222
60622,01/10/2021,54,3500,16,2754,0.052,38,746,0.014,53294,POINT (-87.681818 41.902762),60622-20210110
60642,01/16/2021,39,1636,31,1125,0.057,8,511,0.026,19716,POINT (-87.657821 41.899935),60642-20210116
60707,01/18/2021,13,337,9,268,0.006,4,69,0.002,43093,POINT (-87.808283 41.921777),60707-20210118
Unknown,01/22/2021,42,666,40,580,0,2,86,0,0,,Unknown-20210122
60651,12/29/2020,26,170,26,170,0.003,0,0,0,63492,POINT (-87.741017 41.901964),60651-20201229
60656,01/27/2021,105,1292,86,989,0.035,19,303,0.011,28218,POINT (-87.817934 41.974566),60656-20210127
60636,01/04/2021,11,99,11,99,0.003,0,0,0,30024,POINT (-87.668597 41.77599),60636-20210104
60649,12/25/2020,0,120,0,120,0.003,0,0,0,46633,POINT (-87.571522 41.762202),60649-20201225
60612,01/09/2021,56,1297,16,1092,0.032,40,205,0.006,33735,POINT (-87.687011 41.88004),60612-20210109
60707,12/31/2020,6,120,6,120,0.003,0,0,0,43093,POINT (-87.808283 41.921777),60707-20201231
60640,01/12/2021,248,3315,136,2741,0.04,112,574,0.008,69363,POINT (-87.662232 41.971888),60640-20210112
60601,01/17/2021,13,1012,7,704,0.047,6,308,0.02,15083,POINT (-87.622844 41.886262),60601-20210117
60657,12/26/2020,50,1498,50,1498,0.021,0,0,0,70958,POINT (-87.658216 41.939715),60657-20201226
Unknown,12/17/2020,4,4,4,4,0,0,0,0,0,,Unknown-20201217
60620,01/06/2021,139,481,134,467,0.007,5,14,0,67711,POINT (-87.651656 41.740873),60620-20210106
60633,01/15/2021,8,133,8,110,0.009,0,23,0.002,12689,POINT (-87.556037 41.653147),60633-20210115
60660,12/30/2020,116,557,116,557,0.013,0,0,0,44498,POINT (-87.666362 41.991062),60660-20201230
60656,01/06/2021,24,385,18,379,0.013,6,6,0,28218,POINT (-87.817934 41.974566),60656-20210106
60631,01/11/2021,54,1194,15,930,0.031,39,264,0.009,29529,POINT (-87.813371 41.995019),60631-20210111
60625,01/08/2021,234,1980,86,1746,0.022,148,234,0.003,79444,POINT (-87.701816 41.971155),60625-20210108
60656,01/02/2021,18,302,18,302,0.011,0,0,0,28218,POINT (-87.817934 41.974566),60656-20210102
60602,01/12/2021,9,93,2,66,0.058,7,27,0.024,1145,POINT (-87.628309 41.883136),60602-20210112
60623,12/30/2020,54,356,54,356,0.004,0,0,0,81283,POINT (-87.717446 41.850321),60623-20201230
60656,12/22/2020,16,178,16,178,0.006,0,0,0,28218,POINT (-87.817934 41.974566),60656-20201222
60608,01/03/2021,10,936,10,936,0.012,0,0,0,80059,POINT (-87.670366 41.849879),60608-20210103
60641,12/28/2020,42,484,42,484,0.007,0,0,0,69880,POINT (-87.746791 41.946682),60641-20201228
60641,01/16/2021,79,1974,66,1551,0.022,13,423,0.006,69880,POINT (-87.746791 41.946682),60641-20210116
60622,01/05/2021,136,2383,128,2361,0.044,8,22,0,53294,POINT (-87.681818 41.902762),60622-20210105
60632,01/02/2021,12,416,12,416,0.005,0,0,0,89857,POINT (-87.711251 41.810038),60632-20210102
60614,12/30/2020,141,1751,141,1751,0.024,0,0,0,71954,POINT (-87.652064 41.922605),60614-20201230
60656,02/03/2021,114,1838,88,1432,0.051,26,406,0.014,28218,POINT (-87.817934 41.974566),60656-20210203
60617,12/23/2020,32,189,32,189,0.002,0,0,0,83553,POINT (-87.556897 41.721257),60617-20201223
60656,12/20/2020,12,117,12,117,0.004,0,0,0,28218,POINT (-87.817934 41.974566),60656-20201220
60626,12/17/2020,24,25,24,25,0,0,0,0,50544,POINT (-87.669834 42.009469),60626-20201217
60666,01/18/2021,0,1,0,1,0,0,0,0,0,POINT (-87.896371 41.979511),60666-20210118
60644,12/19/2020,7,25,7,25,0.001,0,0,0,46591,POINT (-87.756863 41.881113),60644-20201219
60602,12/16/2020,0,0,0,0,0,0,0,0,1145,POINT (-87.628309 41.883136),60602-20201216
Unknown,01/18/2021,4,384,3,342,0,1,42,0,0,,Unknown-20210118
60632,12/15/2020,0,0,0,0,0,0,0,0,89857,POINT (-87.711251 41.810038),60632-20201215
60641,12/16/2020,18,18,18,18,0,0,0,0,69880,POINT (-87.746791 41.946682),60641-20201216
60653,01/02/2021,1,400,1,400,0.012,0,0,0,33154,POINT (-87.611244 41.819261),60653-20210102
60643,12/20/2020,26,153,26,153,0.003,0,0,0,48887,POINT (-87.662381 41.700445),60643-20201220
60625,01/03/2021,148,1170,148,1170,0.015,0,0,0,79444,POINT (-87.701816 41.971155),60625-20210103
60639,01/12/2021,110,1073,76,913,0.01,34,160,0.002,88204,POINT (-87.75531 41.920609),60639-20210112
60656,01/17/2021,6,768,5,563,0.02,1,205,0.007,28218,POINT (-87.817934 41.974566),60656-20210117
60626,01/08/2021,152,1342,73,1218,0.024,79,124,0.002,50544,POINT (-87.669834 42.009469),60626-20210108
60637,01/08/2021,86,1106,36,973,0.021,50,133,0.003,47300,POINT (-87.604053 41.780991),60637-20210108
60827,01/22/2021,3,48,3,42,0.001,0,6,0,28483,POINT (-87.633087 41.650765),60827-20210122
60657,01/05/2021,219,2567,206,2544,0.036,13,23,0,70958,POINT (-87.658216 41.939715),60657-20210105
60630,01/11/2021,114,1458,35,1146,0.02,79,312,0.006,56433,POINT (-87.759611 41.971261),60630-20210111
60606,12/24/2020,2,90,2,90,0.027,0,0,0,3287,POINT (-87.63676 41.882634),60606-20201224
60619,01/10/2021,12,517,7,466,0.008,5,51,0.001,61207,POINT (-87.60569 41.744737),60619-20210110
60632,01/15/2021,55,1003,51,860,0.01,4,143,0.002,89857,POINT (-87.711251 41.810038),60632-20210115
60631,01/16/2021,92,1530,88,1199,0.041,4,331,0.011,29529,POINT (-87.813371 41.995019),60631-20210116
60621,12/31/2020,2,179,2,179,0.006,0,0,0,28018,POINT (-87.638812 41.776931),60621-20201231
60827,12/21/2020,0,4,0,4,0,0,0,0,28483,POINT (-87.633087 41.650765),60827-20201221
60666,12/31/2020,0,0,0,0,0,0,0,0,0,POINT (-87.896371 41.979511),60666-20201231
60628,01/07/2021,44,470,28,452,0.007,16,18,0,64254,POINT (-87.621537 41.694192),60628-20210107
60610,12/22/2020,97,577,97,577,0.014,0,0,0,40548,POINT (-87.63581 41.90455),60610-20201222
60609,12/25/2020,0,180,0,180,0.003,0,0,0,60939,POINT (-87.653382 41.812017),60609-20201225
60637,12/18/2020,55,81,55,81,0.002,0,0,0,47300,POINT (-87.604053 41.780991),60637-20201218
60661,01/10/2021,16,803,2,601,0.058,14,202,0.02,10354,POINT (-87.644283 41.882786),60661-20210110
60619,12/22/2020,19,86,19,86,0.001,0,0,0,61207,POINT (-87.60569 41.744737),60619-20201222
60608,12/28/2020,35,606,35,606,0.008,0,0,0,80059,POINT (-87.670366 41.849879),60608-20201228
60661,12/30/2020,32,438,32,438,0.042,0,0,0,10354,POINT (-87.644283 41.882786),60661-20201230
60637,12/20/2020,21,143,21,143,0.003,0,0,0,47300,POINT (-87.604053 41.780991),60637-20201220
60617,12/18/2020,32,57,32,57,0.001,0,0,0,83553,POINT (-87.556897 41.721257),60617-20201218
60639,01/07/2021,62,663,36,627,0.007,26,36,0,88204,POINT (-87.75531 41.920609),60639-20210107
60644,01/13/2021,156,865,142,809,0.017,14,56,0.001,46591,POINT (-87.756863 41.881113),60644-20210113
60652,01/04/2021,30,434,29,433,0.01,1,1,0,43447,POINT (-87.714238 41.745398),60652-20210104
60652,01/26/2021,96,1519,70,1148,0.026,26,371,0.009,43447,POINT (-87.714238 41.745398),60652-20210126
60827,02/04/2021,8,107,7,89,0.003,1,18,0.001,28483,POINT (-87.633087 41.650765),60827-20210204
60609,01/23/2021,83,1596,78,1308,0.021,5,288,0.005,60939,POINT (-87.653382 41.812017),60609-20210123
60639,12/24/2020,13,216,13,216,0.002,0,0,0,88204,POINT (-87.75531 41.920609),60639-20201224
60827,12/30/2020,1,9,1,9,0,0,0,0,28483,POINT (-87.633087 41.650765),60827-20201230
60621,12/16/2020,0,0,0,0,0,0,0,0,28018,POINT (-87.638812 41.776931),60621-20201216
60707,01/03/2021,4,126,4,126,0.003,0,0,0,43093,POINT (-87.808283 41.921777),60707-20210103
60666,02/16/2021,0,23,0,21,0,0,2,0,0,POINT (-87.896371 41.979511),60666-20210216
60636,12/15/2020,0,0,0,0,0,0,0,0,30024,POINT (-87.668597 41.77599),60636-20201215
60621,12/26/2020,1,34,1,34,0.001,0,0,0,28018,POINT (-87.638812 41.776931),60621-20201226
60612,12/21/2020,105,326,105,326,0.01,0,0,0,33735,POINT (-87.687011 41.88004),60612-20201221
60608,12/23/2020,76,532,76,532,0.007,0,0,0,80059,POINT (-87.670366 41.849879),60608-20201223
60652,01/09/2021,24,606,15,555,0.013,9,51,0.001,43447,POINT (-87.714238 41.745398),60652-20210109
60629,12/27/2020,1,287,1,287,0.003,0,0,0,110029,POINT (-87.711565 41.777061),60629-20201227
60614,12/25/2020,0,1282,0,1282,0.018,0,0,0,71954,POINT (-87.652064 41.922605),60614-20201225
60606,12/19/2020,13,49,13,49,0.015,0,0,0,3287,POINT (-87.63676 41.882634),60606-20201219
Unknown,01/07/2021,10,130,8,128,0,2,2,0,0,,Unknown-20210107
60616,12/29/2020,76,789,76,789,0.015,0,0,0,54197,POINT (-87.629531 41.844869),60616-20201229
60666,12/26/2020,0,0,0,0,0,0,0,0,0,POINT (-87.896371 41.979511),60666-20201226
60629,01/18/2021,48,1569,30,1284,0.012,18,285,0.003,110029,POINT (-87.711565 41.777061),60629-20210118
60618,01/02/2021,45,1458,45,1458,0.015,0,0,0,94907,POINT (-87.703343 41.946699),60618-20210102
60653,01/17/2021,6,962,2,792,0.024,4,170,0.005,33154,POINT (-87.611244 41.819261),60653-20210117
60827,01/03/2021,0,9,0,9,0,0,0,0,28483,POINT (-87.633087 41.650765),60827-20210103
60638,12/20/2020,27,170,27,170,0.003,0,0,0,58669,POINT (-87.771902 41.787032),60638-20201220
60622,12/21/2020,263,1013,263,1013,0.019,0,0,0,53294,POINT (-87.681818 41.902762),60622-20201221
60632,12/31/2020,30,403,30,403,0.004,0,0,0,89857,POINT (-87.711251 41.810038),60632-20201231
60609,12/22/2020,34,137,34,137,0.002,0,0,0,60939,POINT (-87.653382 41.812017),60609-20201222
60622,12/31/2020,97,2087,97,2087,0.039,0,0,0,53294,POINT (-87.681818 41.902762),60622-20201231
60660,12/26/2020,5,347,5,347,0.008,0,0,0,44498,POINT (-87.666362 41.991062),60660-20201226
60642,01/03/2021,7,715,7,715,0.036,0,0,0,19716,POINT (-87.657821 41.899935),60642-20210103
60660,01/10/2021,12,1798,7,1605,0.036,5,193,0.004,44498,POINT (-87.666362 41.991062),60660-20210110
Unknown,12/23/2020,8,35,8,35,0,0,0,0,0,,Unknown-20201223
60610,12/17/2020,63,65,63,65,0.002,0,0,0,40548,POINT (-87.63581 41.90455),60610-20201217
60618,12/16/2020,3,3,3,3,0,0,0,0,94907,POINT (-87.703343 41.946699),60618-20201216
60642,12/17/2020,49,52,49,52,0.003,0,0,0,19716,POINT (-87.657821 41.899935),60642-20201217
Unknown,12/21/2020,12,22,12,22,0,0,0,0,0,,Unknown-20201221
60666,01/15/2021,0,1,0,1,0,0,0,0,0,POINT (-87.896371 41.979511),60666-20210115
60620,01/02/2021,6,263,6,263,0.004,0,0,0,67711,POINT (-87.651656 41.740873),60620-20210102
60625,12/20/2020,7,303,7,303,0.004,0,0,0,79444,POINT (-87.701816 41.971155),60625-20201220
Unknown,02/08/2021,8,1257,7,962,0,1,295,0,0,,Unknown-20210208
60636,12/18/2020,5,8,5,8,0,0,0,0,30024,POINT (-87.668597 41.77599),60636-20201218
60651,12/17/2020,5,5,5,5,0,0,0,0,63492,POINT (-87.741017 41.901964),60651-20201217
60618,01/17/2021,54,3754,32,2829,0.03,22,925,0.01,94907,POINT (-87.703343 41.946699),60618-20210117
60640,12/24/2020,39,725,39,725,0.01,0,0,0,69363,POINT (-87.662232 41.971888),60640-20201224
60624,01/10/2021,3,247,1,222,0.006,2,25,0.001,34892,POINT (-87.722735 41.879417),60624-20210110
60655,01/02/2021,127,656,127,656,0.023,0,0,0,28569,POINT (-87.701434 41.696456),60655-20210102
60622,01/15/2021,124,4625,115,3340,0.063,9,1285,0.024,53294,POINT (-87.681818 41.902762),60622-20210115
60642,12/28/2020,27,550,27,550,0.028,0,0,0,19716,POINT (-87.657821 41.899935),60642-20201228
60630,12/17/2020,29,33,29,33,0.001,0,0,0,56433,POINT (-87.759611 41.971261),60630-20201217
60632,01/17/2021,11,1066,6,911,0.01,5,155,0.002,89857,POINT (-87.711251 41.810038),60632-20210117
60630,12/27/2020,0,434,0,434,0.008,0,0,0,56433,POINT (-87.759611 41.971261),60630-20201227
60649,12/30/2020,23,296,23,296,0.006,0,0,0,46633,POINT (-87.571522 41.762202),60649-20201230
60643,01/01/2021,0,457,0,457,0.009,0,0,0,48887,POINT (-87.662381 41.700445),60643-20210101
60618,01/07/2021,185,2101,78,1958,0.021,107,143,0.002,94907,POINT (-87.703343 41.946699),60618-20210107
60645,01/05/2021,118,947,117,944,0.02,1,3,0,47270,POINT (-87.695049 42.008927),60645-20210105
60620,12/26/2020,2,135,2,135,0.002,0,0,0,67711,POINT (-87.651656 41.740873),60620-20201226
60631,12/15/2020,0,0,0,0,0,0,0,0,29529,POINT (-87.813371 41.995019),60631-20201215
60612,01/05/2021,49,944,47,941,0.028,2,3,0,33735,POINT (-87.687011 41.88004),60612-20210105
60607,01/03/2021,14,1449,13,1448,0.049,1,1,0,29293,POINT (-87.652727 41.876104),60607-20210103
60645,12/19/2020,49,135,49,135,0.003,0,0,0,47270,POINT (-87.695049 42.008927),60645-20201219
60601,12/24/2020,9,307,9,307,0.02,0,0,0,15083,POINT (-87.622844 41.886262),60601-20201224
60645,12/21/2020,52,198,52,198,0.004,0,0,0,47270,POINT (-87.695049 42.008927),60645-20201221
60623,01/01/2021,0,394,0,394,0.005,0,0,0,81283,POINT (-87.717446 41.850321),60623-20210101
60618,12/23/2020,113,879,113,879,0.009,0,0,0,94907,POINT (-87.703343 41.946699),60618-20201223
60606,01/20/2021,24,319,9,205,0.062,15,114,0.035,3287,POINT (-87.63676 41.882634),60606-20210120
60628,12/23/2020,20,101,20,101,0.002,0,0,0,64254,POINT (-87.621537 41.694192),60628-20201223
60625,12/19/2020,99,296,99,296,0.004,0,0,0,79444,POINT (-87.701816 41.971155),60625-20201219
60618,01/14/2021,169,3455,130,2582,0.027,39,873,0.009,94907,POINT (-87.703343 41.946699),60618-20210114
60638,01/12/2021,94,1115,43,853,0.015,51,262,0.004,58669,POINT (-87.771902 41.787032),60638-20210112
60607,12/19/2020,161,510,161,510,0.017,0,0,0,29293,POINT (-87.652727 41.876104),60607-20201219
60631,01/06/2021,55,776,37,756,0.026,18,20,0.001,29529,POINT (-87.813371 41.995019),60631-20210106
60653,01/14/2021,69,918,61,759,0.023,8,159,0.005,33154,POINT (-87.611244 41.819261),60653-20210114
60655,12/20/2020,39,223,39,223,0.008,0,0,0,28569,POINT (-87.701434 41.696456),60655-20201220
60644,12/22/2020,9,56,9,56,0.001,0,0,0,46591,POINT (-87.756863 41.881113),60644-20201222
60655,01/21/2021,115,1777,102,1357,0.047,13,420,0.015,28569,POINT (-87.701434 41.696456),60655-20210121
60610,01/18/2021,105,2446,53,1729,0.043,52,717,0.018,40548,POINT (-87.63581 41.90455),60610-20210118
60666,02/01/2021,1,10,1,10,0,0,0,0,0,POINT (-87.896371 41.979511),60666-20210201
60827,01/18/2021,1,36,1,31,0.001,0,5,0,28483,POINT (-87.633087 41.650765),60827-20210118
60653,12/21/2020,31,101,31,101,0.003,0,0,0,33154,POINT (-87.611244 41.819261),60653-20201221
60610,01/01/2021,2,901,2,901,0.022,0,0,0,40548,POINT (-87.63581 41.90455),60610-20210101
60707,12/17/2020,1,2,1,2,0,0,0,0,43093,POINT (-87.808283 41.921777),60707-20201217
60629,01/11/2021,72,1018,27,858,0.008,45,160,0.001,110029,POINT (-87.711565 41.777061),60629-20210111
60644,12/29/2020,30,173,30,173,0.004,0,0,0,46591,POINT (-87.756863 41.881113),60644-20201229
60653,12/30/2020,48,390,48,390,0.012,0,0,0,33154,POINT (-87.611244 41.819261),60653-20201230
60652,12/25/2020,0,154,0,154,0.004,0,0,0,43447,POINT (-87.714238 41.745398),60652-20201225
60622,01/01/2021,2,2089,2,2089,0.039,0,0,0,53294,POINT (-87.681818 41.902762),60622-20210101
60606,12/23/2020,4,88,4,88,0.027,0,0,0,3287,POINT (-87.63676 41.882634),60606-20201223
60625,01/15/2021,112,2871,105,2266,0.029,7,605,0.008,79444,POINT (-87.701816 41.971155),60625-20210115
60608,01/07/2021,111,1284,64,1214,0.015,47,70,0.001,80059,POINT (-87.670366 41.849879),60608-20210107
60605,12/15/2020,0,0,0,0,0,0,0,0,29060,POINT (-87.623449 41.867824),60605-20201215
60641,01/12/2021,133,1548,90,1228,0.018,43,320,0.005,69880,POINT (-87.746791 41.946682),60641-20210112
60624,01/05/2021,21,168,21,168,0.005,0,0,0,34892,POINT (-87.722735 41.879417),60624-20210105
60656,01/31/2021,14,1571,13,1228,0.044,1,343,0.012,28218,POINT (-87.817934 41.974566),60656-20210131
60628,01/03/2021,6,241,5,240,0.004,1,1,0,64254,POINT (-87.621537 41.694192),60628-20210103
60619,12/23/2020,25,111,25,111,0.002,0,0,0,61207,POINT (-87.60569 41.744737),60619-20201223
60617,12/19/2020,15,72,15,72,0.001,0,0,0,83553,POINT (-87.556897 41.721257),60617-20201219
60633,01/23/2021,16,247,14,200,0.016,2,47,0.004,12689,POINT (-87.556037 41.653147),60633-20210123
60632,01/06/2021,32,546,26,538,0.006,6,8,0,89857,POINT (-87.711251 41.810038),60632-20210106
60639,01/03/2021,11,411,11,411,0.005,0,0,0,88204,POINT (-87.75531 41.920609),60639-20210103
60606,01/03/2021,0,129,0,129,0.039,0,0,0,3287,POINT (-87.63676 41.882634),60606-20210103
60621,12/27/2020,0,34,0,34,0.001,0,0,0,28018,POINT (-87.638812 41.776931),60621-20201227
60602,12/28/2020,4,34,4,34,0.03,0,0,0,1145,POINT (-87.628309 41.883136),60602-20201228
60666,01/22/2021,0,2,0,2,0,0,0,0,0,POINT (-87.896371 41.979511),60666-20210122
60643,12/16/2020,1,1,1,1,0,0,0,0,48887,POINT (-87.662381 41.700445),60643-20201216
60608,01/12/2021,186,2034,96,1614,0.02,90,420,0.005,80059,POINT (-87.670366 41.849879),60608-20210112
60609,01/09/2021,34,681,23,620,0.01,11,61,0.001,60939,POINT (-87.653382 41.812017),60609-20210109
60629,12/26/2020,9,286,9,286,0.003,0,0,0,110029,POINT (-87.711565 41.777061),60629-20201226
60619,01/14/2021,139,830,131,726,0.012,8,104,0.002,61207,POINT (-87.60569 41.744737),60619-20210114
60653,01/06/2021,30,489,21,476,0.014,9,13,0,33154,POINT (-87.611244 41.819261),60653-20210106
60827,12/17/2020,0,0,0,0,0,0,0,0,28483,POINT (-87.633087 41.650765),60827-20201217
60655,12/25/2020,0,374,0,374,0.013,0,0,0,28569,POINT (-87.701434 41.696456),60655-20201225
60827,12/31/2020,0,9,0,9,0,0,0,0,28483,POINT (-87.633087 41.650765),60827-20201231
60666,12/27/2020,0,0,0,0,0,0,0,0,0,POINT (-87.896371 41.979511),60666-20201227
60623,12/31/2020,38,394,38,394,0.005,0,0,0,81283,POINT (-87.717446 41.850321),60623-20201231
60639,12/23/2020,28,203,28,203,0.002,0,0,0,88204,POINT (-87.75531 41.920609),60639-20201223
60652,12/17/2020,12,13,12,13,0,0,0,0,43447,POINT (-87.714238 41.745398),60652-20201217
60641,01/07/2021,99,1083,41,996,0.014,58,87,0.001,69880,POINT (-87.746791 41.946682),60641-20210107
60611,12/17/2020,172,187,172,187,0.006,0,0,0,33224,POINT (-87.620291 41.894734),60611-20201217
60623,12/21/2020,31,87,31,87,0.001,0,0,0,81283,POINT (-87.717446 41.850321),60623-20201221
60637,01/04/2021,70,780,64,769,0.016,6,11,0,47300,POINT (-87.604053 41.780991),60637-20210104
60638,12/15/2020,0,0,0,0,0,0,0,0,58669,POINT (-87.771902 41.787032),60638-20201215
60609,12/29/2020,37,243,37,243,0.004,0,0,0,60939,POINT (-87.653382 41.812017),60609-20201229
60628,01/20/2021,136,1044,108,872,0.014,28,172,0.003,64254,POINT (-87.621537 41.694192),60628-20210120
60652,01/08/2021,48,582,27,540,0.012,21,42,0.001,43447,POINT (-87.714238 41.745398),60652-20210108
60632,01/01/2021,1,404,1,404,0.004,0,0,0,89857,POINT (-87.711251 41.810038),60632-20210101
60630,01/02/2021,23,673,23,673,0.012,0,0,0,56433,POINT (-87.759611 41.971261),60630-20210102
60644,01/09/2021,14,649,10,624,0.013,4,25,0.001,46591,POINT (-87.756863 41.881113),60644-20210109
60609,01/19/2021,64,1174,41,944,0.015,23,230,0.004,60939,POINT (-87.653382 41.812017),60609-20210119
60633,02/07/2021,9,621,9,521,0.041,0,100,0.008,12689,POINT (-87.556037 41.653147),60633-20210207
60610,12/29/2020,68,778,68,778,0.019,0,0,0,40548,POINT (-87.63581 41.90455),60610-20201229
60707,01/07/2021,14,168,7,159,0.004,7,9,0,43093,POINT (-87.808283 41.921777),60707-20210107
60827,12/26/2020,0,7,0,7,0,0,0,0,28483,POINT (-87.633087 41.650765),60827-20201226
60666,02/12/2021,1,23,1,21,0,0,2,0,0,POINT (-87.896371 41.979511),60666-20210212
60631,01/17/2021,43,1573,39,1238,0.042,4,335,0.011,29529,POINT (-87.813371 41.995019),60631-20210117
60626,12/27/2020,0,339,0,339,0.007,0,0,0,50544,POINT (-87.669834 42.009469),60626-20201227
60617,12/30/2020,52,343,52,343,0.004,0,0,0,83553,POINT (-87.556897 41.721257),60617-20201230
60616,12/25/2020,0,646,0,646,0.012,0,0,0,54197,POINT (-87.629531 41.844869),60616-20201225
60639,12/28/2020,32,249,32,249,0.003,0,0,0,88204,POINT (-87.75531 41.920609),60639-20201228
60656,01/14/2021,45,716,34,520,0.018,11,196,0.007,28218,POINT (-87.817934 41.974566),60656-20210114
60619,12/18/2020,27,34,27,34,0.001,0,0,0,61207,POINT (-87.60569 41.744737),60619-20201218
60629,12/31/2020,27,523,27,523,0.005,0,0,0,110029,POINT (-87.711565 41.777061),60629-20201231
60612,12/17/2020,42,44,42,44,0.001,0,0,0,33735,POINT (-87.687011 41.88004),60612-20201217
60623,12/26/2020,4,159,4,159,0.002,0,0,0,81283,POINT (-87.717446 41.850321),60623-20201226
60614,12/20/2020,48,679,48,679,0.009,0,0,0,71954,POINT (-87.652064 41.922605),60614-20201220
60630,01/17/2021,20,1931,13,1509,0.027,7,422,0.007,56433,POINT (-87.759611 41.971261),60630-20210117
60618,01/10/2021,26,2619,8,2139,0.023,18,480,0.005,94907,POINT (-87.703343 41.946699),60618-20210110
60607,12/24/2020,43,996,43,996,0.034,0,0,0,29293,POINT (-87.652727 41.876104),60607-20201224
60642,12/23/2020,53,498,53,498,0.025,0,0,0,19716,POINT (-87.657821 41.899935),60642-20201223
60642,01/07/2021,90,945,24,857,0.043,66,88,0.004,19716,POINT (-87.657821 41.899935),60642-20210107
60660,01/14/2021,81,2174,67,1849,0.042,14,325,0.007,44498,POINT (-87.666362 41.991062),60660-20210114
60666,01/11/2021,0,0,0,0,0,0,0,0,0,POINT (-87.896371 41.979511),60666-20210111
60707,12/23/2020,15,71,15,71,0.002,0,0,0,43093,POINT (-87.808283 41.921777),60707-20201223
60641,01/02/2021,22,692,22,692,0.01,0,0,0,69880,POINT (-87.746791 41.946682),60641-20210102
60636,12/28/2020,10,42,10,42,0.001,0,0,0,30024,POINT (-87.668597 41.77599),60636-20201228
60707,12/21/2020,13,42,13,42,0.001,0,0,0,43093,POINT (-87.808283 41.921777),60707-20201221
60618,12/26/2020,25,942,25,942,0.01,0,0,0,94907,POINT (-87.703343 41.946699),60618-20201226
60609,12/18/2020,32,41,32,41,0.001,0,0,0,60939,POINT (-87.653382 41.812017),60609-20201218
60624,12/21/2020,11,35,11,35,0.001,0,0,0,34892,POINT (-87.722735 41.879417),60624-20201221
60620,01/17/2021,4,899,3,761,0.011,1,138,0.002,67711,POINT (-87.651656 41.740873),60620-20210117
60621,01/01/2021,0,179,0,179,0.006,0,0,0,28018,POINT (-87.638812 41.776931),60621-20210101
60661,01/05/2021,25,537,24,531,0.051,1,6,0.001,10354,POINT (-87.644283 41.882786),60661-20210105
60612,01/18/2021,38,1973,20,1443,0.043,18,530,0.016,33735,POINT (-87.687011 41.88004),60612-20210118
60639,12/15/2020,0,0,0,0,0,0,0,0,88204,POINT (-87.75531 41.920609),60639-20201215
Unknown,12/26/2020,3,41,3,41,0,0,0,0,0,,Unknown-20201226
60625,12/18/2020,160,197,160,197,0.002,0,0,0,79444,POINT (-87.701816 41.971155),60625-20201218
60617,01/10/2021,6,692,1,611,0.007,5,81,0.001,83553,POINT (-87.556897 41.721257),60617-20210110
60641,01/17/2021,24,1998,12,1563,0.022,12,435,0.006,69880,POINT (-87.746791 41.946682),60641-20210117
60655,01/06/2021,54,776,34,750,0.026,20,26,0.001,28569,POINT (-87.701434 41.696456),60655-20210106
60642,12/24/2020,15,513,15,513,0.026,0,0,0,19716,POINT (-87.657821 41.899935),60642-20201224
60657,01/10/2021,153,3840,105,3026,0.043,48,814,0.011,70958,POINT (-87.658216 41.939715),60657-20210110
60649,01/04/2021,17,343,15,341,0.007,2,2,0,46633,POINT (-87.571522 41.762202),60649-20210104
60640,01/03/2021,98,1326,98,1326,0.019,0,0,0,69363,POINT (-87.662232 41.971888),60640-20210103
60620,12/30/2020,53,245,53,245,0.004,0,0,0,67711,POINT (-87.651656 41.740873),60620-20201230
60827,01/15/2021,3,33,3,28,0.001,0,5,0,28483,POINT (-87.633087 41.650765),60827-20210115
60628,12/19/2020,10,38,10,38,0.001,0,0,0,64254,POINT (-87.621537 41.694192),60628-20201219
60625,12/31/2020,85,989,85,989,0.012,0,0,0,79444,POINT (-87.701816 41.971155),60625-20201231
60638,12/18/2020,73,95,73,95,0.002,0,0,0,58669,POINT (-87.771902 41.787032),60638-20201218
60632,12/27/2020,0,160,0,160,0.002,0,0,0,89857,POINT (-87.711251 41.810038),60632-20201227
60643,01/05/2021,38,551,32,544,0.011,6,7,0,48887,POINT (-87.662381 41.700445),60643-20210105
60608,12/24/2020,32,564,32,564,0.007,0,0,0,80059,POINT (-87.670366 41.849879),60608-20201224
Unknown,01/27/2021,58,807,43,688,0,15,119,0,0,,Unknown-20210127
60661,01/04/2021,34,512,29,507,0.049,5,5,0,10354,POINT (-87.644283 41.882786),60661-20210104
60633,01/06/2021,7,75,6,74,0.006,1,1,0,12689,POINT (-87.556037 41.653147),60633-20210106
60642,12/16/2020,3,3,3,3,0,0,0,0,19716,POINT (-87.657821 41.899935),60642-20201216
60612,01/01/2021,0,798,0,798,0.024,0,0,0,33735,POINT (-87.687011 41.88004),60612-20210101
60643,12/21/2020,61,214,61,214,0.004,0,0,0,48887,POINT (-87.662381 41.700445),60643-20201221
60630,12/22/2020,33,364,33,364,0.006,0,0,0,56433,POINT (-87.759611 41.971261),60630-20201222
60601,12/28/2020,22,339,22,339,0.022,0,0,0,15083,POINT (-87.622844 41.886262),60601-20201228
60632,01/11/2021,46,741,22,662,0.007,24,79,0.001,89857,POINT (-87.711251 41.810038),60632-20210111
60633,12/15/2020,0,0,0,0,0,0,0,0,12689,POINT (-87.556037 41.653147),60633-20201215
60629,01/15/2021,60,1383,54,1129,0.01,6,254,0.002,110029,POINT (-87.711565 41.777061),60629-20210115
60638,01/16/2021,38,1384,28,1058,0.018,10,326,0.006,58669,POINT (-87.771902 41.787032),60638-20210116
60653,01/21/2021,86,1239,73,996,0.03,13,243,0.007,33154,POINT (-87.611244 41.819261),60653-20210121
60666,01/28/2021,1,6,1,6,0,0,0,0,0,POINT (-87.896371 41.979511),60666-20210128
60631,01/02/2021,133,604,133,604,0.02,0,0,0,29529,POINT (-87.813371 41.995019),60631-20210102
60610,01/13/2021,105,2076,54,1461,0.036,51,615,0.015,40548,POINT (-87.63581 41.90455),60610-20210113
60827,02/01/2021,1,84,0,71,0.002,1,13,0,28483,POINT (-87.633087 41.650765),60827-20210201
60623,01/05/2021,34,498,34,497,0.006,0,1,0,81283,POINT (-87.717446 41.850321),60623-20210105
60645,12/24/2020,11,283,11,283,0.006,0,0,0,47270,POINT (-87.695049 42.008927),60645-20201224
60620,01/14/2021,41,838,35,708,0.01,6,130,0.002,67711,POINT (-87.651656 41.740873),60620-20210114
60657,12/20/2020,45,766,45,766,0.011,0,0,0,70958,POINT (-87.658216 41.939715),60657-20201220
60653,12/17/2020,10,10,10,10,0,0,0,0,33154,POINT (-87.611244 41.819261),60653-20201217
60636,01/12/2021,14,193,10,174,0.006,4,19,0.001,30024,POINT (-87.668597 41.77599),60636-20210112
60653,12/26/2020,0,169,0,169,0.005,0,0,0,33154,POINT (-87.611244 41.819261),60653-20201226
60655,12/16/2020,0,0,0,0,0,0,0,0,28569,POINT (-87.701434 41.696456),60655-20201216
60623,01/10/2021,7,782,4,734,0.009,3,48,0.001,81283,POINT (-87.717446 41.850321),60623-20210110
60630,01/06/2021,84,990,64,966,0.017,20,24,0,56433,POINT (-87.759611 41.971261),60630-20210106
60640,12/17/2020,41,44,41,44,0.001,0,0,0,69363,POINT (-87.662232 41.971888),60640-20201217
60626,01/11/2021,92,1512,43,1296,0.026,49,216,0.004,50544,POINT (-87.669834 42.009469),60626-20210111
60637,01/11/2021,52,1266,7,1008,0.021,45,258,0.005,47300,POINT (-87.604053 41.780991),60637-20210111
60655,12/30/2020,59,498,59,498,0.017,0,0,0,28569,POINT (-87.701434 41.696456),60655-20201230
60660,01/04/2021,92,724,88,720,0.016,4,4,0,44498,POINT (-87.666362 41.991062),60660-20210104
60655,01/09/2021,41,1026,4,804,0.028,37,222,0.008,28569,POINT (-87.701434 41.696456),60655-20210109
60827,01/27/2021,5,61,4,53,0.002,1,8,0,28483,POINT (-87.633087 41.650765),60827-20210127
Unknown,02/01/2021,13,963,11,824,0,2,139,0,0,,Unknown-20210201
60644,12/25/2020,0,82,0,82,0.002,0,0,0,46591,POINT (-87.756863 41.881113),60644-20201225
60602,12/24/2020,2,30,2,30,0.026,0,0,0,1145,POINT (-87.628309 41.883136),60602-20201224
60631,12/16/2020,3,3,3,3,0,0,0,0,29529,POINT (-87.813371 41.995019),60631-20201216
60606,01/07/2021,9,159,5,146,0.044,4,13,0.004,3287,POINT (-87.63676 41.882634),60606-20210107
60633,12/22/2020,5,19,5,19,0.001,0,0,0,12689,POINT (-87.556037 41.653147),60633-20201222
Unknown,01/10/2021,1,152,0,143,0,1,9,0,0,,Unknown-20210110
60601,12/17/2020,29,31,29,31,0.002,0,0,0,15083,POINT (-87.622844 41.886262),60601-20201217
60620,01/09/2021,21,637,17,572,0.008,4,65,0.001,67711,POINT (-87.651656 41.740873),60620-20210109
60605,12/25/2020,0,1208,0,1208,0.042,0,0,0,29060,POINT (-87.623449 41.867824),60605-20201225
60645,12/29/2020,130,450,130,450,0.01,0,0,0,47270,POINT (-87.695049 42.008927),60645-20201229
60666,01/24/2021,0,2,0,2,0,0,0,0,0,POINT (-87.896371 41.979511),60666-20210124
60606,01/24/2021,4,377,4,255,0.078,0,122,0.037,3287,POINT (-87.63676 41.882634),60606-20210124
60625,01/11/2021,176,2284,57,1860,0.023,119,424,0.005,79444,POINT (-87.701816 41.971155),60625-20210111
60609,01/13/2021,60,886,32,722,0.012,28,164,0.003,60939,POINT (-87.653382 41.812017),60609-20210113
60617,01/14/2021,63,973,52,789,0.009,11,184,0.002,83553,POINT (-87.556897 41.721257),60617-20210114
60633,02/12/2021,49,842,32,680,0.054,17,162,0.013,12689,POINT (-87.556037 41.653147),60633-20210212
60619,01/19/2021,108,1060,85,913,0.015,23,147,0.002,61207,POINT (-87.60569 41.744737),60619-20210119
60656,12/30/2020,26,271,26,271,0.01,0,0,0,28218,POINT (-87.817934 41.974566),60656-20201230
60666,12/18/2020,0,0,0,0,0,0,0,0,0,POINT (-87.896371 41.979511),60666-20201218
60637,01/16/2021,99,1694,53,1278,0.027,46,416,0.009,47300,POINT (-87.604053 41.780991),60637-20210116
60628,01/15/2021,37,749,37,648,0.01,0,101,0.002,64254,POINT (-87.621537 41.694192),60628-20210115
60649,12/18/2020,27,40,27,40,0.001,0,0,0,46633,POINT (-87.571522 41.762202),60649-20201218
60640,01/18/2021,132,4224,67,3432,0.049,65,792,0.011,69363,POINT (-87.662232 41.971888),60640-20210118
60651,01/03/2021,2,251,2,251,0.004,0,0,0,63492,POINT (-87.741017 41.901964),60651-20210103
60656,01/26/2021,51,1187,34,903,0.032,17,284,0.01,28218,POINT (-87.817934 41.974566),60656-20210126
60666,12/23/2020,0,0,0,0,0,0,0,0,0,POINT (-87.896371 41.979511),60666-20201223
60619,01/02/2021,7,274,7,274,0.004,0,0,0,61207,POINT (-87.60569 41.744737),60619-20210102
60621,12/21/2020,6,24,6,24,0.001,0,0,0,28018,POINT (-87.638812 41.776931),60621-20201221
60607,12/29/2020,117,1178,117,1178,0.04,0,0,0,29293,POINT (-87.652727 41.876104),60607-20201229
60617,12/26/2020,3,202,3,202,0.002,0,0,0,83553,POINT (-87.556897 41.721257),60617-20201226
60640,12/15/2020,0,0,0,0,0,0,0,0,69363,POINT (-87.662232 41.971888),60640-20201215
60666,02/08/2021,0,14,0,14,0,0,0,0,0,POINT (-87.896371 41.979511),60666-20210208
60619,01/17/2021,6,903,3,791,0.013,3,112,0.002,61207,POINT (-87.60569 41.744737),60619-20210117
60641,12/23/2020,49,407,49,407,0.006,0,0,0,69880,POINT (-87.746791 41.946682),60641-20201223
60640,01/24/2021,66,5615,63,4576,0.066,3,1039,0.015,69363,POINT (-87.662232 41.971888),60640-20210124
60649,01/13/2021,118,910,102,815,0.017,16,95,0.002,46633,POINT (-87.571522 41.762202),60649-20210113
60642,01/17/2021,11,1647,6,1131,0.057,5,516,0.026,19716,POINT (-87.657821 41.899935),60642-20210117
60617,12/17/2020,24,25,24,25,0,0,0,0,83553,POINT (-87.556897 41.721257),60617-20201217
60619,12/30/2020,43,244,43,244,0.004,0,0,0,61207,POINT (-87.60569 41.744737),60619-20201230
60644,01/05/2021,207,545,207,545,0.012,0,0,0,46591,POINT (-87.756863 41.881113),60644-20210105
60637,12/28/2020,14,377,14,377,0.008,0,0,0,47300,POINT (-87.604053 41.780991),60637-20201228
60626,12/31/2020,32,746,32,746,0.015,0,0,0,50544,POINT (-87.669834 42.009469),60626-20201231
60609,01/02/2021,5,341,5,341,0.006,0,0,0,60939,POINT (-87.653382 41.812017),60609-20210102
60610,12/25/2020,0,643,0,643,0.016,0,0,0,40548,POINT (-87.63581 41.90455),60610-20201225
60639,01/18/2021,63,1430,49,1210,0.014,14,220,0.002,88204,POINT (-87.75531 41.920609),60639-20210118
60633,12/27/2020,0,26,0,26,0.002,0,0,0,12689,POINT (-87.556037 41.653147),60633-20201227
60707,01/11/2021,17,225,7,190,0.004,10,35,0.001,43093,POINT (-87.808283 41.921777),60707-20210111
60612,12/29/2020,83,668,83,668,0.02,0,0,0,33735,POINT (-87.687011 41.88004),60612-20201229
60629,12/19/2020,33,102,33,102,0.001,0,0,0,110029,POINT (-87.711565 41.777061),60629-20201219
Unknown,01/15/2021,51,346,51,309,0,0,37,0,0,,Unknown-20210115
60636,12/24/2020,2,30,2,30,0.001,0,0,0,30024,POINT (-87.668597 41.77599),60636-20201224
60636,01/16/2021,7,242,6,215,0.007,1,27,0.001,30024,POINT (-87.668597 41.77599),60636-20210116
60607,01/12/2021,224,2835,75,2028,0.069,149,807,0.028,29293,POINT (-87.652727 41.876104),60607-20210112
60633,02/02/2021,33,461,28,383,0.03,5,78,0.006,12689,POINT (-87.556037 41.653147),60633-20210202
60638,01/19/2021,101,1555,63,1179,0.02,38,376,0.006,58669,POINT (-87.771902 41.787032),60638-20210119
60643,01/09/2021,51,916,14,747,0.015,37,169,0.003,48887,POINT (-87.662381 41.700445),60643-20210109
60649,01/08/2021,153,591,134,550,0.012,19,41,0.001,46633,POINT (-87.571522 41.762202),60649-20210108
60657,01/14/2021,155,4909,107,3519,0.05,48,1390,0.02,70958,POINT (-87.658216 41.939715),60657-20210114
60707,12/27/2020,0,75,0,75,0.002,0,0,0,43093,POINT (-87.808283 41.921777),60707-20201227
60633,01/01/2021,0,48,0,48,0.004,0,0,0,12689,POINT (-87.556037 41.653147),60633-20210101
60616,12/20/2020,37,339,37,339,0.006,0,0,0,54197,POINT (-87.629531 41.844869),60616-20201220
60637,12/15/2020,0,0,0,0,0,0,0,0,47300,POINT (-87.604053 41.780991),60637-20201215
60609,12/16/2020,0,0,0,0,0,0,0,0,60939,POINT (-87.653382 41.812017),60609-20201216
60629,01/10/2021,17,946,4,831,0.008,13,115,0.001,110029,POINT (-87.711565 41.777061),60629-20210110
60640,01/07/2021,159,2121,87,2012,0.029,72,109,0.002,69363,POINT (-87.662232 41.971888),60640-20210107
60628,12/31/2020,16,231,16,231,0.004,0,0,0,64254,POINT (-87.621537 41.694192),60628-20201231
60628,01/18/2021,39,809,30,694,0.011,9,115,0.002,64254,POINT (-87.621537 41.694192),60628-20210118
60618,12/30/2020,161,1331,161,1331,0.014,0,0,0,94907,POINT (-87.703343 41.946699),60618-20201230
60638,12/28/2020,30,357,30,357,0.006,0,0,0,58669,POINT (-87.771902 41.787032),60638-20201228
60652,01/18/2021,28,914,20,760,0.017,8,154,0.004,43447,POINT (-87.714238 41.745398),60652-20210118
60633,01/28/2021,27,350,22,282,0.022,5,68,0.005,12689,POINT (-87.556037 41.653147),60633-20210128
60645,01/13/2021,99,1640,64,1389,0.029,35,251,0.005,47270,POINT (-87.695049 42.008927),60645-20210113
60620,12/18/2020,38,54,38,54,0.001,0,0,0,67711,POINT (-87.651656 41.740873),60620-20201218
60653,01/23/2021,62,1411,60,1159,0.035,2,252,0.008,33154,POINT (-87.611244 41.819261),60653-20210123
60666,01/07/2021,0,0,0,0,0,0,0,0,0,POINT (-87.896371 41.979511),60666-20210107
60660,01/19/2021,95,2495,54,2083,0.047,41,412,0.009,44498,POINT (-87.666362 41.991062),60660-20210119
60624,12/26/2020,1,59,1,59,0.002,0,0,0,34892,POINT (-87.722735 41.879417),60624-20201226
60601,01/16/2021,25,999,20,697,0.046,5,302,0.02,15083,POINT (-87.622844 41.886262),60601-20210116
60601,01/18/2021,31,1043,10,714,0.047,21,329,0.022,15083,POINT (-87.622844 41.886262),60601-20210118
60653,12/22/2020,32,133,32,133,0.004,0,0,0,33154,POINT (-87.611244 41.819261),60653-20201222
60643,12/25/2020,0,311,0,311,0.006,0,0,0,48887,POINT (-87.662381 41.700445),60643-20201225
60629,01/03/2021,20,560,20,560,0.005,0,0,0,110029,POINT (-87.711565 41.777061),60629-20210103
60605,12/23/2020,133,1166,133,1166,0.04,0,0,0,29060,POINT (-87.623449 41.867824),60605-20201223
60625,12/27/2020,0,643,0,643,0.008,0,0,0,79444,POINT (-87.701816 41.971155),60625-20201227
60632,12/22/2020,34,118,34,118,0.001,0,0,0,89857,POINT (-87.711251 41.810038),60632-20201222
60656,01/09/2021,33,529,8,412,0.015,25,117,0.004,28218,POINT (-87.817934 41.974566),60656-20210109
60602,12/15/2020,0,0,0,0,0,0,0,0,1145,POINT (-87.628309 41.883136),60602-20201215
60827,01/10/2021,0,19,0,17,0.001,0,2,0,28483,POINT (-87.633087 41.650765),60827-20210110
60621,01/05/2021,17,205,15,203,0.007,2,2,0,28018,POINT (-87.638812 41.776931),60621-20210105
60661,12/18/2020,88,136,88,136,0.013,0,0,0,10354,POINT (-87.644283 41.882786),60661-20201218
Unknown,12/31/2020,3,87,3,87,0,0,0,0,0,,Unknown-20201231
60656,12/25/2020,0,194,0,194,0.007,0,0,0,28218,POINT (-87.817934 41.974566),60656-20201225
60601,01/01/2021,1,415,1,415,0.028,0,0,0,15083,POINT (-87.622844 41.886262),60601-20210101
60610,01/09/2021,105,1670,23,1309,0.032,82,361,0.009,40548,POINT (-87.63581 41.90455),60610-20210109
60827,02/09/2021,3,127,2,105,0.004,1,22,0.001,28483,POINT (-87.633087 41.650765),60827-20210209
60649,12/29/2020,131,273,131,273,0.006,0,0,0,46633,POINT (-87.571522 41.762202),60649-20201229
60622,01/14/2021,206,4501,168,3225,0.061,38,1276,0.024,53294,POINT (-87.681818 41.902762),60622-20210114
60642,01/12/2021,118,1418,50,992,0.05,68,426,0.022,19716,POINT (-87.657821 41.899935),60642-20210112
60640,12/23/2020,80,686,80,686,0.01,0,0,0,69363,POINT (-87.662232 41.971888),60640-20201223
60612,01/13/2021,131,1696,58,1243,0.037,73,453,0.013,33735,POINT (-87.687011 41.88004),60612-20210113
60657,12/30/2020,216,2006,216,2006,0.028,0,0,0,70958,POINT (-87.658216 41.939715),60657-20201230
60638,01/04/2021,44,620,40,616,0.01,4,4,0,58669,POINT (-87.771902 41.787032),60638-20210104
60610,12/23/2020,45,622,45,622,0.015,0,0,0,40548,POINT (-87.63581 41.90455),60610-20201223
60661,12/31/2020,23,461,23,461,0.045,0,0,0,10354,POINT (-87.644283 41.882786),60661-20201231
60619,12/17/2020,7,7,7,7,0,0,0,0,61207,POINT (-87.60569 41.744737),60619-20201217
60616,12/30/2020,92,881,92,881,0.016,0,0,0,54197,POINT (-87.629531 41.844869),60616-20201230
60827,01/13/2021,3,27,3,23,0.001,0,4,0,28483,POINT (-87.633087 41.650765),60827-20210113
60661,01/11/2021,57,860,7,608,0.059,50,252,0.024,10354,POINT (-87.644283 41.882786),60661-20210111
60607,01/02/2021,23,1435,23,1435,0.049,0,0,0,29293,POINT (-87.652727 41.876104),60607-20210102
60666,02/05/2021,0,14,0,14,0,0,0,0,0,POINT (-87.896371 41.979511),60666-20210205
60642,01/13/2021,85,1503,35,1027,0.052,50,476,0.024,19716,POINT (-87.657821 41.899935),60642-20210113
60644,01/17/2021,6,947,5,874,0.019,1,73,0.002,46591,POINT (-87.756863 41.881113),60644-20210117
60655,01/18/2021,43,1522,40,1148,0.04,3,374,0.013,28569,POINT (-87.701434 41.696456),60655-20210118
60655,01/24/2021,35,2048,34,1610,0.056,1,438,0.015,28569,POINT (-87.701434 41.696456),60655-20210124
60612,01/12/2021,136,1565,62,1185,0.035,74,380,0.011,33735,POINT (-87.687011 41.88004),60612-20210112
60631,01/12/2021,63,1257,36,966,0.033,27,291,0.01,29529,POINT (-87.813371 41.995019),60631-20210112
60601,01/06/2021,20,517,13,506,0.034,7,11,0.001,15083,POINT (-87.622844 41.886262),60601-20210106
60626,12/30/2020,292,714,292,714,0.014,0,0,0,50544,POINT (-87.669834 42.009469),60626-20201230
Unknown,01/19/2021,65,449,51,393,0,14,56,0,0,,Unknown-20210119
60614,12/26/2020,37,1319,37,1319,0.018,0,0,0,71954,POINT (-87.652064 41.922605),60614-20201226
60666,01/09/2021,0,0,0,0,0,0,0,0,0,POINT (-87.896371 41.979511),60666-20210109
60637,12/27/2020,0,363,0,363,0.008,0,0,0,47300,POINT (-87.604053 41.780991),60637-20201227
60613,12/19/2020,121,387,121,387,0.008,0,0,0,50761,POINT (-87.661343 41.953742),60613-20201219
60626,01/04/2021,73,851,72,849,0.017,1,2,0,50544,POINT (-87.669834 42.009469),60626-20210104
60660,12/31/2020,32,589,32,589,0.013,0,0,0,44498,POINT (-87.666362 41.991062),60660-20201231
60640,01/09/2021,129,2750,54,2426,0.035,75,324,0.005,69363,POINT (-87.662232 41.971888),60640-20210109
60653,12/29/2020,150,342,150,342,0.01,0,0,0,33154,POINT (-87.611244 41.819261),60653-20201229
60629,01/08/2021,91,869,56,796,0.007,35,73,0.001,110029,POINT (-87.711565 41.777061),60629-20210108
60827,01/08/2021,3,18,1,16,0.001,2,2,0,28483,POINT (-87.633087 41.650765),60827-20210108
60653,12/24/2020,9,169,9,169,0.005,0,0,0,33154,POINT (-87.611244 41.819261),60653-20201224
60827,01/30/2021,8,82,7,70,0.002,1,12,0,28483,POINT (-87.633087 41.650765),60827-20210130
60632,12/24/2020,11,154,11,154,0.002,0,0,0,89857,POINT (-87.711251 41.810038),60632-20201224
60656,01/03/2021,4,306,4,306,0.011,0,0,0,28218,POINT (-87.817934 41.974566),60656-20210103
60656,12/17/2020,9,10,9,10,0,0,0,0,28218,POINT (-87.817934 41.974566),60656-20201217
60609,01/17/2021,10,1057,4,870,0.014,6,187,0.003,60939,POINT (-87.653382 41.812017),60609-20210117
60633,01/16/2021,4,137,2,112,0.009,2,25,0.002,12689,POINT (-87.556037 41.653147),60633-20210116
60643,12/23/2020,30,301,30,301,0.006,0,0,0,48887,POINT (-87.662381 41.700445),60643-20201223
60628,01/21/2021,100,1144,89,961,0.015,11,183,0.003,64254,POINT (-87.621537 41.694192),60628-20210121
60656,12/23/2020,14,192,14,192,0.007,0,0,0,28218,POINT (-87.817934 41.974566),60656-20201223
60642,01/02/2021,10,708,10,708,0.036,0,0,0,19716,POINT (-87.657821 41.899935),60642-20210102
60610,12/16/2020,2,2,2,2,0,0,0,0,40548,POINT (-87.63581 41.90455),60610-20201216
60612,12/22/2020,86,412,86,412,0.012,0,0,0,33735,POINT (-87.687011 41.88004),60612-20201222
60610,12/18/2020,160,225,160,225,0.006,0,0,0,40548,POINT (-87.63581 41.90455),60610-20201218
60660,12/17/2020,28,30,28,30,0.001,0,0,0,44498,POINT (-87.666362 41.991062),60660-20201217
60630,12/18/2020,96,129,96,129,0.002,0,0,0,56433,POINT (-87.759611 41.971261),60630-20201218
60666,12/21/2020,0,0,0,0,0,0,0,0,0,POINT (-87.896371 41.979511),60666-20201221
60640,01/14/2021,194,3838,169,3143,0.045,25,695,0.01,69363,POINT (-87.662232 41.971888),60640-20210114
60645,01/12/2021,147,1541,120,1325,0.028,27,216,0.005,47270,POINT (-87.695049 42.008927),60645-20210112
60666,01/04/2021,0,0,0,0,0,0,0,0,0,POINT (-87.896371 41.979511),60666-20210104
60647,12/16/2020,8,8,8,8,0,0,0,0,87633,POINT (-87.701101 41.921058),60647-20201216
60645,12/22/2020,38,236,38,236,0.005,0,0,0,47270,POINT (-87.695049 42.008927),60645-20201222
60620,12/25/2020,0,133,0,133,0.002,0,0,0,67711,POINT (-87.651656 41.740873),60620-20201225
60624,12/31/2020,16,118,16,118,0.003,0,0,0,34892,POINT (-87.722735 41.879417),60624-20201231
60605,12/18/2020,267,401,267,401,0.014,0,0,0,29060,POINT (-87.623449 41.867824),60605-20201218
60636,01/06/2021,15,126,14,124,0.004,1,2,0,30024,POINT (-87.668597 41.77599),60636-20210106
60601,01/11/2021,67,782,12,572,0.038,55,210,0.014,15083,POINT (-87.622844 41.886262),60601-20210111
60666,12/30/2020,0,0,0,0,0,0,0,0,0,POINT (-87.896371 41.979511),60666-20201230
60622,01/11/2021,307,3807,95,2849,0.053,212,958,0.018,53294,POINT (-87.681818 41.902762),60622-20210111
60651,12/30/2020,49,219,49,219,0.003,0,0,0,63492,POINT (-87.741017 41.901964),60651-20201230
60611,12/16/2020,15,15,15,15,0,0,0,0,33224,POINT (-87.620291 41.894734),60611-20201216
60623,01/04/2021,50,464,49,463,0.006,1,1,0,81283,POINT (-87.717446 41.850321),60623-20210104
60607,01/13/2021,195,3030,84,2112,0.072,111,918,0.031,29293,POINT (-87.652727 41.876104),60607-20210113
60602,12/22/2020,4,24,4,24,0.021,0,0,0,1145,POINT (-87.628309 41.883136),60602-20201222
60607,12/22/2020,161,845,161,845,0.029,0,0,0,29293,POINT (-87.652727 41.876104),60607-20201222
Unknown,01/04/2021,4,94,4,94,0,0,0,0,0,,Unknown-20210104
60633,01/29/2021,40,390,39,321,0.025,1,69,0.005,12689,POINT (-87.556037 41.653147),60633-20210129
60601,12/27/2020,0,317,0,317,0.021,0,0,0,15083,POINT (-87.622844 41.886262),60601-20201227
60637,01/01/2021,1,619,1,619,0.013,0,0,0,47300,POINT (-87.604053 41.780991),60637-20210101
60655,12/28/2020,18,397,18,397,0.014,0,0,0,28569,POINT (-87.701434 41.696456),60655-20201228
60652,12/30/2020,54,361,54,361,0.008,0,0,0,43447,POINT (-87.714238 41.745398),60652-20201230
60628,12/20/2020,6,44,6,44,0.001,0,0,0,64254,POINT (-87.621537 41.694192),60628-20201220
60655,01/07/2021,119,895,30,780,0.027,89,115,0.004,28569,POINT (-87.701434 41.696456),60655-20210107
60827,01/23/2021,0,48,0,42,0.001,0,6,0,28483,POINT (-87.633087 41.650765),60827-20210123
60639,01/06/2021,60,601,54,591,0.007,6,10,0,88204,POINT (-87.75531 41.920609),60639-20210106
60649,12/26/2020,1,121,1,121,0.003,0,0,0,46633,POINT (-87.571522 41.762202),60649-20201226
60827,12/29/2020,1,8,1,8,0,0,0,0,28483,POINT (-87.633087 41.650765),60827-20201229
60639,12/19/2020,34,85,34,85,0.001,0,0,0,88204,POINT (-87.75531 41.920609),60639-20201219
60653,12/20/2020,12,70,12,70,0.002,0,0,0,33154,POINT (-87.611244 41.819261),60653-20201220
60621,01/16/2021,8,319,6,288,0.01,2,31,0.001,28018,POINT (-87.638812 41.776931),60621-20210116
60666,02/15/2021,0,23,0,21,0,0,2,0,0,POINT (-87.896371 41.979511),60666-20210215
60610,01/19/2021,113,2559,65,1794,0.044,48,765,0.019,40548,POINT (-87.63581 41.90455),60610-20210119
60707,12/18/2020,15,17,15,17,0,0,0,0,43093,POINT (-87.808283 41.921777),60707-20201218
60617,01/18/2021,64,1186,51,975,0.012,13,211,0.003,83553,POINT (-87.556897 41.721257),60617-20210118
60655,12/23/2020,21,365,21,365,0.013,0,0,0,28569,POINT (-87.701434 41.696456),60655-20201223
60657,12/17/2020,132,142,132,142,0.002,0,0,0,70958,POINT (-87.658216 41.939715),60657-20201217
60660,01/15/2021,73,2247,68,1917,0.043,5,330,0.007,44498,POINT (-87.666362 41.991062),60660-20210115
60612,12/24/2020,35,523,35,523,0.016,0,0,0,33735,POINT (-87.687011 41.88004),60612-20201224
60707,12/30/2020,16,114,16,114,0.003,0,0,0,43093,POINT (-87.808283 41.921777),60707-20201230
60631,12/24/2020,6,341,6,341,0.012,0,0,0,29529,POINT (-87.813371 41.995019),60631-20201224
60629,12/20/2020,20,122,20,122,0.001,0,0,0,110029,POINT (-87.711565 41.777061),60629-20201220
60618,01/03/2021,39,1497,36,1494,0.016,3,3,0,94907,POINT (-87.703343 41.946699),60618-20210103
60657,12/27/2020,1,1499,1,1499,0.021,0,0,0,70958,POINT (-87.658216 41.939715),60657-20201227
60666,12/25/2020,0,0,0,0,0,0,0,0,0,POINT (-87.896371 41.979511),60666-20201225
60620,01/07/2021,52,533,32,499,0.007,20,34,0.001,67711,POINT (-87.651656 41.740873),60620-20210107
60633,12/28/2020,4,30,4,30,0.002,0,0,0,12689,POINT (-87.556037 41.653147),60633-20201228
60641,12/25/2020,0,429,0,429,0.006,0,0,0,69880,POINT (-87.746791 41.946682),60641-20201225
60646,12/16/2020,0,0,0,0,0,0,0,0,28569,POINT (-87.761826 41.993931),60646-20201216
Unknown,12/22/2020,5,27,5,27,0,0,0,0,0,,Unknown-20201222
60608,01/02/2021,14,926,14,926,0.012,0,0,0,80059,POINT (-87.670366 41.849879),60608-20210102
60618,12/19/2020,149,426,149,426,0.004,0,0,0,94907,POINT (-87.703343 41.946699),60618-20201219
60606,12/30/2020,16,118,16,118,0.036,0,0,0,3287,POINT (-87.63676 41.882634),60606-20201230
60645,01/02/2021,14,660,14,660,0.014,0,0,0,47270,POINT (-87.695049 42.008927),60645-20210102
Unknown,02/09/2021,76,1333,32,994,0,44,339,0,0,,Unknown-20210209
60618,12/17/2020,57,60,57,60,0.001,0,0,0,94907,POINT (-87.703343 41.946699),60618-20201217
60666,01/19/2021,1,2,1,2,0,0,0,0,0,POINT (-87.896371 41.979511),60666-20210119
60609,01/12/2021,80,826,50,690,0.011,30,136,0.002,60939,POINT (-87.653382 41.812017),60609-20210112
60641,01/09/2021,66,1296,26,1087,0.016,40,209,0.003,69880,POINT (-87.746791 41.946682),60641-20210109
60666,02/10/2021,2,22,1,20,0,1,2,0,0,POINT (-87.896371 41.979511),60666-20210210
60610,01/12/2021,135,1971,55,1407,0.035,80,564,0.014,40548,POINT (-87.63581 41.90455),60610-20210112
60642,12/29/2020,52,602,52,602,0.031,0,0,0,19716,POINT (-87.657821 41.899935),60642-20201229
60656,01/22/2021,57,1023,55,777,0.028,2,246,0.009,28218,POINT (-87.817934 41.974566),60656-20210122
60656,01/24/2021,17,1082,14,828,0.029,3,254,0.009,28218,POINT (-87.817934 41.974566),60656-20210124
60612,12/15/2020,0,0,0,0,0,0,0,0,33735,POINT (-87.687011 41.88004),60612-20201215
60657,01/11/2021,306,4146,74,3100,0.044,232,1046,0.015,70958,POINT (-87.658216 41.939715),60657-20210111
60653,01/03/2021,11,411,11,411,0.012,0,0,0,33154,POINT (-87.611244 41.819261),60653-20210103
60620,12/23/2020,16,123,16,123,0.002,0,0,0,67711,POINT (-87.651656 41.740873),60620-20201223
60643,12/28/2020,17,330,17,330,0.007,0,0,0,48887,POINT (-87.662381 41.700445),60643-20201228
60827,12/22/2020,2,6,2,6,0,0,0,0,28483,POINT (-87.633087 41.650765),60827-20201222
60639,12/30/2020,57,338,57,338,0.004,0,0,0,88204,POINT (-87.75531 41.920609),60639-20201230
60622,12/27/2020,0,1376,0,1376,0.026,0,0,0,53294,POINT (-87.681818 41.902762),60622-20201227
60606,01/14/2021,7,262,7,175,0.053,0,87,0.026,3287,POINT (-87.63676 41.882634),60606-20210114
60628,12/26/2020,1,112,1,112,0.002,0,0,0,64254,POINT (-87.621537 41.694192),60628-20201226
60602,01/06/2021,3,61,3,60,0.052,0,1,0.001,1145,POINT (-87.628309 41.883136),60602-20210106
60661,12/27/2020,0,359,0,359,0.035,0,0,0,10354,POINT (-87.644283 41.882786),60661-20201227
60616,01/03/2021,20,949,18,947,0.017,2,2,0,54197,POINT (-87.629531 41.844869),60616-20210103
60707,01/14/2021,21,298,15,235,0.005,6,63,0.001,43093,POINT (-87.808283 41.921777),60707-20210114
60653,01/13/2021,49,849,28,698,0.021,21,151,0.005,33154,POINT (-87.611244 41.819261),60653-20210113
60639,12/22/2020,43,175,43,175,0.002,0,0,0,88204,POINT (-87.75531 41.920609),60639-20201222
60642,01/09/2021,103,1194,27,913,0.046,76,281,0.014,19716,POINT (-87.657821 41.899935),60642-20210109
60657,01/08/2021,455,3470,117,2861,0.04,338,609,0.009,70958,POINT (-87.658216 41.939715),60657-20210108
60827,02/05/2021,6,113,5,94,0.003,1,19,0.001,28483,POINT (-87.633087 41.650765),60827-20210205
60645,01/17/2021,16,1838,14,1566,0.033,2,272,0.006,47270,POINT (-87.695049 42.008927),60645-20210117
60636,12/22/2020,4,21,4,21,0.001,0,0,0,30024,POINT (-87.668597 41.77599),60636-20201222
60655,01/22/2021,154,1931,146,1503,0.053,8,428,0.015,28569,POINT (-87.701434 41.696456),60655-20210122
60607,01/06/2021,77,1771,52,1724,0.059,25,47,0.002,29293,POINT (-87.652727 41.876104),60607-20210106
60666,01/31/2021,0,9,0,9,0,0,0,0,0,POINT (-87.896371 41.979511),60666-20210131
60623,12/15/2020,0,0,0,0,0,0,0,0,81283,POINT (-87.717446 41.850321),60623-20201215
60621,12/17/2020,5,5,5,5,0,0,0,0,28018,POINT (-87.638812 41.776931),60621-20201217
60644,01/02/2021,86,299,86,299,0.006,0,0,0,46591,POINT (-87.756863 41.881113),60644-20210102
Unknown,01/23/2021,25,691,25,605,0,0,86,0,0,,Unknown-20210123
60640,12/30/2020,205,1134,205,1134,0.016,0,0,0,69363,POINT (-87.662232 41.971888),60640-20201230
60644,12/15/2020,0,0,0,0,0,0,0,0,46591,POINT (-87.756863 41.881113),60644-20201215
60607,01/19/2021,151,3534,60,2417,0.083,91,1117,0.038,29293,POINT (-87.652727 41.876104),60607-20210119
60652,01/14/2021,43,825,39,693,0.016,4,132,0.003,43447,POINT (-87.714238 41.745398),60652-20210114
60644,12/28/2020,58,143,58,143,0.003,0,0,0,46591,POINT (-87.756863 41.881113),60644-20201228
60661,01/15/2021,28,1034,26,700,0.068,2,334,0.032,10354,POINT (-87.644283 41.882786),60661-20210115
60617,01/08/2021,71,654,43,591,0.007,28,63,0.001,83553,POINT (-87.556897 41.721257),60617-20210108
60651,12/26/2020,3,115,3,115,0.002,0,0,0,63492,POINT (-87.741017 41.901964),60651-20201226
60618,01/13/2021,201,3286,108,2452,0.026,93,834,0.009,94907,POINT (-87.703343 41.946699),60618-20210113
60630,12/29/2020,64,532,64,532,0.009,0,0,0,56433,POINT (-87.759611 41.971261),60630-20201229
60649,01/10/2021,5,614,3,564,0.012,2,50,0.001,46633,POINT (-87.571522 41.762202),60649-20210110
60653,01/18/2021,38,1000,24,816,0.025,14,184,0.006,33154,POINT (-87.611244 41.819261),60653-20210118
60656,01/07/2021,46,431,8,387,0.014,38,44,0.002,28218,POINT (-87.817934 41.974566),60656-20210107
60602,01/01/2021,0,44,0,44,0.038,0,0,0,1145,POINT (-87.628309 41.883136),60602-20210101
60707,01/19/2021,95,432,81,349,0.008,14,83,0.002,43093,POINT (-87.808283 41.921777),60707-20210119
Unknown,12/18/2020,4,8,4,8,0,0,0,0,0,,Unknown-20201218
60612,01/16/2021,29,1928,28,1420,0.042,1,508,0.015,33735,POINT (-87.687011 41.88004),60612-20210116
60622,12/20/2020,54,750,54,750,0.014,0,0,0,53294,POINT (-87.681818 41.902762),60622-20201220
60656,12/21/2020,45,162,45,162,0.006,0,0,0,28218,POINT (-87.817934 41.974566),60656-20201221
60638,01/01/2021,2,539,2,539,0.009,0,0,0,58669,POINT (-87.771902 41.787032),60638-20210101
60827,01/04/2021,2,11,2,11,0,0,0,0,28483,POINT (-87.633087 41.650765),60827-20210104
60632,12/28/2020,28,188,28,188,0.002,0,0,0,89857,POINT (-87.711251 41.810038),60632-20201228
60638,12/21/2020,54,224,54,224,0.004,0,0,0,58669,POINT (-87.771902 41.787032),60638-20201221
60624,01/04/2021,22,147,22,147,0.004,0,0,0,34892,POINT (-87.722735 41.879417),60624-20210104
60626,12/18/2020,79,104,79,104,0.002,0,0,0,50544,POINT (-87.669834 42.009469),60626-20201218
60660,12/27/2020,0,347,0,347,0.008,0,0,0,44498,POINT (-87.666362 41.991062),60660-20201227
60625,12/21/2020,130,433,130,433,0.005,0,0,0,79444,POINT (-87.701816 41.971155),60625-20201221
60608,12/18/2020,118,153,118,153,0.002,0,0,0,80059,POINT (-87.670366 41.849879),60608-20201218
60602,12/27/2020,0,30,0,30,0.026,0,0,0,1145,POINT (-87.628309 41.883136),60602-20201227
60618,01/18/2021,144,3898,83,2912,0.031,61,986,0.01,94907,POINT (-87.703343 41.946699),60618-20210118
60601,12/22/2020,48,269,48,269,0.018,0,0,0,15083,POINT (-87.622844 41.886262),60601-20201222
60636,12/19/2020,1,9,1,9,0,0,0,0,30024,POINT (-87.668597 41.77599),60636-20201219
60612,01/17/2021,7,1935,3,1423,0.042,4,512,0.015,33735,POINT (-87.687011 41.88004),60612-20210117
60651,12/16/2020,0,0,0,0,0,0,0,0,63492,POINT (-87.741017 41.901964),60651-20201216
60617,01/03/2021,7,375,7,375,0.004,0,0,0,83553,POINT (-87.556897 41.721257),60617-20210103
60630,12/24/2020,11,425,11,425,0.008,0,0,0,56433,POINT (-87.759611 41.971261),60630-20201224
60640,12/25/2020,0,725,0,725,0.01,0,0,0,69363,POINT (-87.662232 41.971888),60640-20201225
60628,01/10/2021,5,560,2,511,0.008,3,49,0.001,64254,POINT (-87.621537 41.694192),60628-20210110
60649,12/31/2020,12,308,12,308,0.007,0,0,0,46633,POINT (-87.571522 41.762202),60649-20201231
60666,12/17/2020,0,0,0,0,0,0,0,0,0,POINT (-87.896371 41.979511),60666-20201217
60608,01/13/2021,163,2197,93,1707,0.021,70,490,0.006,80059,POINT (-87.670366 41.849879),60608-20210113
60622,01/16/2021,83,4708,77,3417,0.064,6,1291,0.024,53294,POINT (-87.681818 41.902762),60622-20210116
60637,01/05/2021,48,828,32,801,0.017,16,27,0.001,47300,POINT (-87.604053 41.780991),60637-20210105
60610,01/07/2021,108,1292,29,1184,0.029,79,108,0.003,40548,POINT (-87.63581 41.90455),60610-20210107
60621,01/11/2021,5,264,2,245,0.009,3,19,0.001,28018,POINT (-87.638812 41.776931),60621-20210111
60623,01/15/2021,48,1115,47,977,0.012,1,138,0.002,81283,POINT (-87.717446 41.850321),60623-20210115
60655,01/03/2021,12,668,12,668,0.023,0,0,0,28569,POINT (-87.701434 41.696456),60655-20210103
60619,01/07/2021,31,422,22,406,0.007,9,16,0,61207,POINT (-87.60569 41.744737),60619-20210107
60660,12/15/2020,0,0,0,0,0,0,0,0,44498,POINT (-87.666362 41.991062),60660-20201215
60628,12/18/2020,21,28,21,28,0,0,0,0,64254,POINT (-87.621537 41.694192),60628-20201218
60637,12/19/2020,41,122,41,122,0.003,0,0,0,47300,POINT (-87.604053 41.780991),60637-20201219
60637,12/21/2020,34,177,34,177,0.004,0,0,0,47300,POINT (-87.604053 41.780991),60637-20201221
60607,12/18/2020,244,349,244,349,0.012,0,0,0,29293,POINT (-87.652727 41.876104),60607-20201218
60631,01/05/2021,49,721,48,719,0.024,1,2,0,29529,POINT (-87.813371 41.995019),60631-20210105
60827,01/19/2021,3,39,3,34,0.001,0,5,0,28483,POINT (-87.633087 41.650765),60827-20210119
60633,01/25/2021,13,266,9,214,0.017,4,52,0.004,12689,POINT (-87.556037 41.653147),60633-20210125
60644,12/23/2020,22,78,22,78,0.002,0,0,0,46591,POINT (-87.756863 41.881113),60644-20201223
60652,01/03/2021,11,404,11,404,0.009,0,0,0,43447,POINT (-87.714238 41.745398),60652-20210103
60606,01/09/2021,13,202,3,156,0.047,10,46,0.014,3287,POINT (-87.63676 41.882634),60606-20210109
60625,01/05/2021,127,1432,124,1425,0.018,3,7,0,79444,POINT (-87.701816 41.971155),60625-20210105
60639,12/25/2020,0,216,0,216,0.002,0,0,0,88204,POINT (-87.75531 41.920609),60639-20201225
60636,01/01/2021,0,83,0,83,0.003,0,0,0,30024,POINT (-87.668597 41.77599),60636-20210101
60609,01/07/2021,52,597,36,572,0.009,16,25,0,60939,POINT (-87.653382 41.812017),60609-20210107
60707,01/04/2021,7,133,6,132,0.003,1,1,0,43093,POINT (-87.808283 41.921777),60707-20210104
60644,12/16/2020,0,0,0,0,0,0,0,0,46591,POINT (-87.756863 41.881113),60644-20201216
60610,01/17/2021,21,2341,14,1676,0.041,7,665,0.016,40548,POINT (-87.63581 41.90455),60610-20210117
60630,01/13/2021,114,1679,71,1292,0.023,43,387,0.007,56433,POINT (-87.759611 41.971261),60630-20210113
60653,12/16/2020,0,0,0,0,0,0,0,0,33154,POINT (-87.611244 41.819261),60653-20201216
60606,12/18/2020,29,36,29,36,0.011,0,0,0,3287,POINT (-87.63676 41.882634),60606-20201218
60633,12/24/2020,3,26,3,26,0.002,0,0,0,12689,POINT (-87.556037 41.653147),60633-20201224
60638,01/11/2021,63,1021,21,810,0.014,42,211,0.004,58669,POINT (-87.771902 41.787032),60638-20210111
60638,01/05/2021,47,667,44,660,0.011,3,7,0,58669,POINT (-87.771902 41.787032),60638-20210105
60629,12/18/2020,50,69,50,69,0.001,0,0,0,110029,POINT (-87.711565 41.777061),60629-20201218
Unknown,01/08/2021,9,139,4,132,0,5,7,0,0,,Unknown-20210108
60610,01/02/2021,34,935,34,935,0.023,0,0,0,40548,POINT (-87.63581 41.90455),60610-20210102
60619,12/25/2020,0,121,0,121,0.002,0,0,0,61207,POINT (-87.60569 41.744737),60619-20201225
60612,01/06/2021,52,996,43,984,0.029,9,12,0,33735,POINT (-87.687011 41.88004),60612-20210106
60641,12/29/2020,79,563,79,563,0.008,0,0,0,69880,POINT (-87.746791 41.946682),60641-20201229
60602,01/11/2021,5,84,0,64,0.056,5,20,0.017,1145,POINT (-87.628309 41.883136),60602-20210111
60631,12/21/2020,74,281,74,281,0.01,0,0,0,29529,POINT (-87.813371 41.995019),60631-20201221
60614,12/31/2020,44,1795,44,1795,0.025,0,0,0,71954,POINT (-87.652064 41.922605),60614-20201231
60609,12/23/2020,36,173,36,173,0.003,0,0,0,60939,POINT (-87.653382 41.812017),60609-20201223
60602,12/17/2020,1,1,1,1,0.001,0,0,0,1145,POINT (-87.628309 41.883136),60602-20201217
60652,01/10/2021,12,618,3,558,0.013,9,60,0.001,43447,POINT (-87.714238 41.745398),60652-20210110
60603,12/27/2020,0,36,0,36,0.034,0,0,0,1052,POINT (-87.625473 41.880112),60603-20201227
60643,01/17/2021,10,1604,6,1298,0.027,4,306,0.006,48887,POINT (-87.662381 41.700445),60643-20210117
60640,01/26/2021,321,6140,220,4944,0.071,101,1196,0.017,69363,POINT (-87.662232 41.971888),60640-20210126
60644,01/07/2021,20,599,12,589,0.013,8,10,0,46591,POINT (-87.756863 41.881113),60644-20210107
60660,01/11/2021,74,1872,32,1637,0.037,42,235,0.005,44498,POINT (-87.666362 41.991062),60660-20210111
60666,01/14/2021,0,1,0,1,0,0,0,0,0,POINT (-87.896371 41.979511),60666-20210114
60617,12/20/2020,10,82,10,82,0.001,0,0,0,83553,POINT (-87.556897 41.721257),60617-20201220
60616,12/19/2020,81,302,81,302,0.006,0,0,0,54197,POINT (-87.629531 41.844869),60616-20201219
60656,01/18/2021,21,789,18,581,0.021,3,208,0.007,28218,POINT (-87.817934 41.974566),60656-20210118
60622,12/15/2020,0,0,0,0,0,0,0,0,53294,POINT (-87.681818 41.902762),60622-20201215
60625,01/04/2021,135,1305,131,1301,0.016,4,4,0,79444,POINT (-87.701816 41.971155),60625-20210104
60613,12/16/2020,7,7,7,7,0,0,0,0,50761,POINT (-87.661343 41.953742),60613-20201216
60638,12/27/2020,0,327,0,327,0.006,0,0,0,58669,POINT (-87.771902 41.787032),60638-20201227
60621,12/28/2020,60,94,60,94,0.003,0,0,0,28018,POINT (-87.638812 41.776931),60621-20201228
60619,01/09/2021,25,505,18,459,0.007,7,46,0.001,61207,POINT (-87.60569 41.744737),60619-20210109
60641,01/13/2021,152,1700,94,1322,0.019,58,378,0.005,69880,POINT (-87.746791 41.946682),60641-20210113
60618,01/08/2021,294,2395,96,2054,0.022,198,341,0.004,94907,POINT (-87.703343 41.946699),60618-20210108
60640,01/17/2021,42,4092,34,3365,0.049,8,727,0.01,69363,POINT (-87.662232 41.971888),60640-20210117
60606,12/25/2020,0,90,0,90,0.027,0,0,0,3287,POINT (-87.63676 41.882634),60606-20201225
60649,01/15/2021,40,998,32,888,0.019,8,110,0.002,46633,POINT (-87.571522 41.762202),60649-20210115
60639,01/09/2021,47,800,20,707,0.008,27,93,0.001,88204,POINT (-87.75531 41.920609),60639-20210109
60630,01/12/2021,107,1565,75,1221,0.022,32,344,0.006,56433,POINT (-87.759611 41.971261),60630-20210112
60608,12/29/2020,98,704,98,704,0.009,0,0,0,80059,POINT (-87.670366 41.849879),60608-20201229
60651,01/02/2021,12,249,12,249,0.004,0,0,0,63492,POINT (-87.741017 41.901964),60651-20210102
60660,01/08/2021,194,1727,105,1572,0.035,89,155,0.003,44498,POINT (-87.666362 41.991062),60660-20210108
60632,01/16/2021,52,1055,45,905,0.01,7,150,0.002,89857,POINT (-87.711251 41.810038),60632-20210116
60645,01/06/2021,87,1034,80,1024,0.022,7,10,0,47270,POINT (-87.695049 42.008927),60645-20210106
60643,01/02/2021,12,469,12,469,0.01,0,0,0,48887,POINT (-87.662381 41.700445),60643-20210102
60628,01/08/2021,65,535,41,493,0.008,24,42,0.001,64254,POINT (-87.621537 41.694192),60628-20210108
60609,12/24/2020,7,180,7,180,0.003,0,0,0,60939,POINT (-87.653382 41.812017),60609-20201224
60619,01/03/2021,6,280,6,280,0.005,0,0,0,61207,POINT (-87.60569 41.744737),60619-20210103
60661,01/03/2021,7,478,7,478,0.046,0,0,0,10354,POINT (-87.644283 41.882786),60661-20210103
60641,12/22/2020,56,358,56,358,0.005,0,0,0,69880,POINT (-87.746791 41.946682),60641-20201222
60632,12/21/2020,31,84,31,84,0.001,0,0,0,89857,POINT (-87.711251 41.810038),60632-20201221
60607,12/30/2020,172,1350,172,1350,0.046,0,0,0,29293,POINT (-87.652727 41.876104),60607-20201230
60624,12/17/2020,8,9,8,9,0,0,0,0,34892,POINT (-87.722735 41.879417),60624-20201217
60628,01/19/2021,99,908,70,764,0.012,29,144,0.002,64254,POINT (-87.621537 41.694192),60628-20210119
60666,01/27/2021,1,5,1,5,0,0,0,0,0,POINT (-87.896371 41.979511),60666-20210127
60653,01/22/2021,110,1349,103,1099,0.033,7,250,0.008,33154,POINT (-87.611244 41.819261),60653-20210122
60610,01/16/2021,67,2320,56,1662,0.041,11,658,0.016,40548,POINT (-87.63581 41.90455),60610-20210116
60613,12/15/2020,0,0,0,0,0,0,0,0,50761,POINT (-87.661343 41.953742),60613-20201215
60827,01/31/2021,1,83,1,71,0.002,0,12,0,28483,POINT (-87.633087 41.650765),60827-20210131
60617,01/04/2021,36,411,33,408,0.005,3,3,0,83553,POINT (-87.556897 41.721257),60617-20210104
60620,01/13/2021,63,797,50,673,0.01,13,124,0.002,67711,POINT (-87.651656 41.740873),60620-20210113
60636,01/11/2021,7,179,6,164,0.005,1,15,0,30024,POINT (-87.668597 41.77599),60636-20210111
60608,12/22/2020,114,456,114,456,0.006,0,0,0,80059,POINT (-87.670366 41.849879),60608-20201222
Unknown,01/14/2021,44,295,39,258,0,5,37,0,0,,Unknown-20210114
60640,12/16/2020,3,3,3,3,0,0,0,0,69363,POINT (-87.662232 41.971888),60640-20201216
60707,01/10/2021,7,208,2,183,0.004,5,25,0.001,43093,POINT (-87.808283 41.921777),60707-20210110
60619,01/08/2021,58,480,35,441,0.007,23,39,0.001,61207,POINT (-87.60569 41.744737),60619-20210108
60607,12/25/2020,0,996,0,996,0.034,0,0,0,29293,POINT (-87.652727 41.876104),60607-20201225
60618,01/09/2021,198,2593,77,2131,0.022,121,462,0.005,94907,POINT (-87.703343 41.946699),60618-20210109
60623,01/11/2021,52,834,28,762,0.009,24,72,0.001,81283,POINT (-87.717446 41.850321),60623-20210111
60624,01/08/2021,21,233,13,213,0.006,8,20,0.001,34892,POINT (-87.722735 41.879417),60624-20210108
60643,01/16/2021,60,1594,56,1292,0.026,4,302,0.006,48887,POINT (-87.662381 41.700445),60643-20210116
60622,01/04/2021,103,2247,90,2233,0.042,13,14,0,53294,POINT (-87.681818 41.902762),60622-20210104
60655,01/25/2021,120,2168,94,1704,0.06,26,464,0.016,28569,POINT (-87.701434 41.696456),60655-20210125
60652,12/23/2020,30,145,30,145,0.003,0,0,0,43447,POINT (-87.714238 41.745398),60652-20201223
60656,01/30/2021,68,1557,55,1215,0.043,13,342,0.012,28218,POINT (-87.817934 41.974566),60656-20210130
60638,12/19/2020,48,143,48,143,0.002,0,0,0,58669,POINT (-87.771902 41.787032),60638-20201219
60646,12/15/2020,0,0,0,0,0,0,0,0,28569,POINT (-87.761826 41.993931),60646-20201215
60644,12/24/2020,4,82,4,82,0.002,0,0,0,46591,POINT (-87.756863 41.881113),60644-20201224
60633,01/22/2021,27,231,21,186,0.015,6,45,0.004,12689,POINT (-87.556037 41.653147),60633-20210122
60624,12/20/2020,1,24,1,24,0.001,0,0,0,34892,POINT (-87.722735 41.879417),60624-20201220
60601,12/18/2020,65,96,65,96,0.006,0,0,0,15083,POINT (-87.622844 41.886262),60601-20201218
60640,01/06/2021,295,1962,272,1925,0.028,23,37,0.001,69363,POINT (-87.662232 41.971888),60640-20210106
60620,01/18/2021,36,935,27,788,0.012,9,147,0.002,67711,POINT (-87.651656 41.740873),60620-20210118
60618,12/29/2020,157,1170,157,1170,0.012,0,0,0,94907,POINT (-87.703343 41.946699),60618-20201229
60657,01/04/2021,185,2348,176,2338,0.033,9,10,0,70958,POINT (-87.658216 41.939715),60657-20210104
60626,01/10/2021,13,1420,4,1253,0.025,9,167,0.003,50544,POINT (-87.669834 42.009469),60626-20210110
60637,01/15/2021,128,1595,97,1225,0.026,31,370,0.008,47300,POINT (-87.604053 41.780991),60637-20210115
60625,01/10/2021,21,2108,13,1803,0.023,8,305,0.004,79444,POINT (-87.701816 41.971155),60625-20210110
60649,01/18/2021,56,1072,46,951,0.02,10,121,0.003,46633,POINT (-87.571522 41.762202),60649-20210118
60602,12/31/2020,0,44,0,44,0.038,0,0,0,1145,POINT (-87.628309 41.883136),60602-20201231
60642,12/25/2020,0,513,0,513,0.026,0,0,0,19716,POINT (-87.657821 41.899935),60642-20201225
60628,01/14/2021,31,712,26,611,0.01,5,101,0.002,64254,POINT (-87.621537 41.694192),60628-20210114
60660,01/18/2021,62,2400,34,2029,0.046,28,371,0.008,44498,POINT (-87.666362 41.991062),60660-20210118
60645,12/20/2020,11,146,11,146,0.003,0,0,0,47270,POINT (-87.695049 42.008927),60645-20201220
60601,01/19/2021,44,1087,22,736,0.049,22,351,0.023,15083,POINT (-87.622844 41.886262),60601-20210119
60630,12/28/2020,34,468,34,468,0.008,0,0,0,56433,POINT (-87.759611 41.971261),60630-20201228
60633,01/05/2021,9,68,9,68,0.005,0,0,0,12689,POINT (-87.556037 41.653147),60633-20210105
60623,12/20/2020,6,56,6,56,0.001,0,0,0,81283,POINT (-87.717446 41.850321),60623-20201220
60608,01/09/2021,156,1628,94,1396,0.017,62,232,0.003,80059,POINT (-87.670366 41.849879),60608-20210109
60661,12/17/2020,41,48,41,48,0.005,0,0,0,10354,POINT (-87.644283 41.882786),60661-20201217
60652,12/16/2020,0,1,0,1,0,0,0,0,43447,POINT (-87.714238 41.745398),60652-20201216
60612,01/02/2021,7,805,7,805,0.024,0,0,0,33735,POINT (-87.687011 41.88004),60612-20210102
60632,01/12/2021,77,818,47,709,0.008,30,109,0.001,89857,POINT (-87.711251 41.810038),60632-20210112
60617,12/25/2020,0,199,0,199,0.002,0,0,0,83553,POINT (-87.556897 41.721257),60617-20201225
60652,01/07/2021,43,534,30,513,0.012,13,21,0,43447,POINT (-87.714238 41.745398),60652-20210107
60647,12/15/2020,0,0,0,0,0,0,0,0,87633,POINT (-87.701101 41.921058),60647-20201215
60630,01/01/2021,0,650,0,650,0.012,0,0,0,56433,POINT (-87.759611 41.971261),60630-20210101
60629,01/14/2021,97,1323,84,1075,0.01,13,248,0.002,110029,POINT (-87.711565 41.777061),60629-20210114
60621,01/08/2021,18,252,14,240,0.009,4,12,0,28018,POINT (-87.638812 41.776931),60621-20210108
60631,01/01/2021,0,471,0,471,0.016,0,0,0,29529,POINT (-87.813371 41.995019),60631-20210101
60638,01/15/2021,55,1346,45,1030,0.018,10,316,0.005,58669,POINT (-87.771902 41.787032),60638-20210115
60644,01/12/2021,38,709,32,667,0.014,6,42,0.001,46591,POINT (-87.756863 41.881113),60644-20210112
60655,12/21/2020,75,298,75,298,0.01,0,0,0,28569,POINT (-87.701434 41.696456),60655-20201221
60609,01/20/2021,97,1271,69,1013,0.017,28,258,0.004,60939,POINT (-87.653382 41.812017),60609-20210120
60619,12/29/2020,48,201,48,201,0.003,0,0,0,61207,POINT (-87.60569 41.744737),60619-20201229
60633,02/06/2021,41,612,39,512,0.04,2,100,0.008,12689,POINT (-87.556037 41.653147),60633-20210206
60651,12/23/2020,20,106,20,106,0.002,0,0,0,63492,POINT (-87.741017 41.901964),60651-20201223
60610,12/28/2020,52,710,52,710,0.018,0,0,0,40548,POINT (-87.63581 41.90455),60610-20201228
60609,01/03/2021,4,345,4,345,0.006,0,0,0,60939,POINT (-87.653382 41.812017),60609-20210103
60639,12/29/2020,32,281,32,281,0.003,0,0,0,88204,POINT (-87.75531 41.920609),60639-20201229
60656,01/13/2021,59,671,44,486,0.017,15,185,0.007,28218,POINT (-87.817934 41.974566),60656-20210113
60707,01/08/2021,19,187,12,171,0.004,7,16,0,43093,POINT (-87.808283 41.921777),60707-20210108
60623,12/27/2020,0,159,0,159,0.002,0,0,0,81283,POINT (-87.717446 41.850321),60623-20201227
60637,01/10/2021,30,1214,4,1001,0.021,26,213,0.005,47300,POINT (-87.604053 41.780991),60637-20210110
60642,12/22/2020,82,445,82,445,0.023,0,0,0,19716,POINT (-87.657821 41.899935),60642-20201222
60628,01/04/2021,132,373,132,372,0.006,0,1,0,64254,POINT (-87.621537 41.694192),60628-20210104
60636,12/27/2020,0,32,0,32,0.001,0,0,0,30024,POINT (-87.668597 41.77599),60636-20201227
60641,01/01/2021,0,670,0,670,0.01,0,0,0,69880,POINT (-87.746791 41.946682),60641-20210101
60644,12/20/2020,5,30,5,30,0.001,0,0,0,46591,POINT (-87.756863 41.881113),60644-20201220
60633,12/21/2020,4,14,4,14,0.001,0,0,0,12689,POINT (-87.556037 41.653147),60633-20201221
60652,01/24/2021,12,1246,12,1005,0.023,0,241,0.006,43447,POINT (-87.714238 41.745398),60652-20210124
60609,12/19/2020,19,60,19,60,0.001,0,0,0,60939,POINT (-87.653382 41.812017),60609-20201219
60606,01/06/2021,4,150,1,141,0.043,3,9,0.003,3287,POINT (-87.63676 41.882634),60606-20210106
60624,12/15/2020,0,0,0,0,0,0,0,0,34892,POINT (-87.722735 41.879417),60624-20201215
60639,01/13/2021,84,1157,57,970,0.011,27,187,0.002,88204,POINT (-87.75531 41.920609),60639-20210113
60638,12/31/2020,27,537,27,537,0.009,0,0,0,58669,POINT (-87.771902 41.787032),60638-20201231
60643,12/19/2020,42,127,42,127,0.003,0,0,0,48887,POINT (-87.662381 41.700445),60643-20201219
60656,12/29/2020,31,245,31,245,0.009,0,0,0,28218,POINT (-87.817934 41.974566),60656-20201229
60606,01/19/2021,9,295,5,196,0.06,4,99,0.03,3287,POINT (-87.63676 41.882634),60606-20210119
60617,01/09/2021,32,686,19,610,0.007,13,76,0.001,83553,POINT (-87.556897 41.721257),60617-20210109
60619,01/13/2021,87,691,71,595,0.01,16,96,0.002,61207,POINT (-87.60569 41.744737),60619-20210113
60656,01/12/2021,30,612,15,442,0.016,15,170,0.006,28218,POINT (-87.817934 41.974566),60656-20210112
60649,01/03/2021,11,326,11,326,0.007,0,0,0,46633,POINT (-87.571522 41.762202),60649-20210103
60616,12/23/2020,76,614,76,614,0.011,0,0,0,54197,POINT (-87.629531 41.844869),60616-20201223
60608,12/25/2020,1,565,1,565,0.007,0,0,0,80059,POINT (-87.670366 41.849879),60608-20201225
60642,01/01/2021,0,698,0,698,0.035,0,0,0,19716,POINT (-87.657821 41.899935),60642-20210101
60614,12/19/2020,178,631,178,631,0.009,0,0,0,71954,POINT (-87.652064 41.922605),60614-20201219
60625,12/30/2020,134,904,134,904,0.011,0,0,0,79444,POINT (-87.701816 41.971155),60625-20201230
60643,01/06/2021,150,701,130,674,0.014,20,27,0.001,48887,POINT (-87.662381 41.700445),60643-20210106
60656,02/04/2021,136,1974,110,1542,0.055,26,432,0.015,28218,POINT (-87.817934 41.974566),60656-20210204
60643,12/22/2020,57,271,57,271,0.006,0,0,0,48887,POINT (-87.662381 41.700445),60643-20201222
60625,12/26/2020,16,643,16,643,0.008,0,0,0,79444,POINT (-87.701816 41.971155),60625-20201226
60629,01/04/2021,42,602,41,601,0.005,1,1,0,110029,POINT (-87.711565 41.777061),60629-20210104
60630,12/21/2020,102,331,102,331,0.006,0,0,0,56433,POINT (-87.759611 41.971261),60630-20201221
60609,12/28/2020,24,206,24,206,0.003,0,0,0,60939,POINT (-87.653382 41.812017),60609-20201228
60612,12/23/2020,76,488,76,488,0.014,0,0,0,33735,POINT (-87.687011 41.88004),60612-20201223
60827,01/09/2021,1,19,1,17,0.001,0,2,0,28483,POINT (-87.633087 41.650765),60827-20210109
60610,12/19/2020,98,323,98,323,0.008,0,0,0,40548,POINT (-87.63581 41.90455),60610-20201219
60645,01/11/2021,70,1394,26,1205,0.025,44,189,0.004,47270,POINT (-87.695049 42.008927),60645-20210111
60666,02/09/2021,6,20,5,19,0,1,1,0,0,POINT (-87.896371 41.979511),60666-20210209
60607,01/14/2021,112,3142,79,2191,0.075,33,951,0.032,29293,POINT (-87.652727 41.876104),60607-20210114
60611,12/15/2020,0,0,0,0,0,0,0,0,33224,POINT (-87.620291 41.894734),60611-20201215
60643,01/12/2021,81,1089,41,834,0.017,40,255,0.005,48887,POINT (-87.662381 41.700445),60643-20210112
60640,01/13/2021,329,3644,233,2974,0.043,96,670,0.01,69363,POINT (-87.662232 41.971888),60640-20210113
60617,12/16/2020,1,1,1,1,0,0,0,0,83553,POINT (-87.556897 41.721257),60617-20201216
60653,01/24/2021,17,1428,17,1176,0.035,0,252,0.008,33154,POINT (-87.611244 41.819261),60653-20210124
60655,12/29/2020,42,439,42,439,0.015,0,0,0,28569,POINT (-87.701434 41.696456),60655-20201229
60601,01/02/2021,8,423,8,423,0.028,0,0,0,15083,POINT (-87.622844 41.886262),60601-20210102
60625,01/14/2021,104,2759,87,2161,0.027,17,598,0.008,79444,POINT (-87.701816 41.971155),60625-20210114
60612,12/16/2020,2,2,2,2,0,0,0,0,33735,POINT (-87.687011 41.88004),60612-20201216
60626,12/26/2020,2,339,2,339,0.007,0,0,0,50544,POINT (-87.669834 42.009469),60626-20201226
60640,12/22/2020,135,606,135,606,0.009,0,0,0,69363,POINT (-87.662232 41.971888),60640-20201222
60619,12/19/2020,11,45,11,45,0.001,0,0,0,61207,POINT (-87.60569 41.744737),60619-20201219
60620,12/24/2020,10,133,10,133,0.002,0,0,0,67711,POINT (-87.651656 41.740873),60620-20201224
60629,12/30/2020,95,496,95,496,0.005,0,0,0,110029,POINT (-87.711565 41.777061),60629-20201230
60612,12/18/2020,113,157,113,157,0.005,0,0,0,33735,POINT (-87.687011 41.88004),60612-20201218
60653,12/25/2020,0,169,0,169,0.005,0,0,0,33154,POINT (-87.611244 41.819261),60653-20201225
60637,12/31/2020,46,618,46,618,0.013,0,0,0,47300,POINT (-87.604053 41.780991),60637-20201231
60616,12/26/2020,12,658,12,658,0.012,0,0,0,54197,POINT (-87.629531 41.844869),60616-20201226
60636,01/15/2021,11,235,10,209,0.007,1,26,0.001,30024,POINT (-87.668597 41.77599),60636-20210115
60633,01/12/2021,7,113,4,94,0.007,3,19,0.001,12689,POINT (-87.556037 41.653147),60633-20210112
60626,12/20/2020,8,170,8,170,0.003,0,0,0,50544,POINT (-87.669834 42.009469),60626-20201220
60606,12/22/2020,15,84,15,84,0.026,0,0,0,3287,POINT (-87.63676 41.882634),60606-20201222
60827,01/26/2021,5,56,5,49,0.002,0,7,0,28483,POINT (-87.633087 41.650765),60827-20210126
Unknown,02/10/2021,54,1387,16,1010,0,38,377,0,0,,Unknown-20210210
60707,12/26/2020,0,75,0,75,0.002,0,0,0,43093,POINT (-87.808283 41.921777),60707-20201226
60632,01/05/2021,44,514,43,512,0.006,1,2,0,89857,POINT (-87.711251 41.810038),60632-20210105
60607,01/09/2021,169,2431,29,1916,0.065,140,515,0.018,29293,POINT (-87.652727 41.876104),60607-20210109
60660,12/21/2020,59,243,59,243,0.005,0,0,0,44498,POINT (-87.666362 41.991062),60660-20201221
60612,01/19/2021,129,2102,48,1491,0.044,81,611,0.018,33735,POINT (-87.687011 41.88004),60612-20210119
60644,01/16/2021,20,941,17,869,0.019,3,72,0.002,46591,POINT (-87.756863 41.881113),60644-20210116
60622,01/08/2021,342,3197,67,2686,0.05,275,511,0.01,53294,POINT (-87.681818 41.902762),60622-20210108
60640,01/23/2021,130,5549,118,4513,0.065,12,1036,0.015,69363,POINT (-87.662232 41.971888),60640-20210123
60655,12/24/2020,9,374,9,374,0.013,0,0,0,28569,POINT (-87.701434 41.696456),60655-20201224
60655,01/12/2021,53,1183,25,859,0.03,28,324,0.011,28569,POINT (-87.701434 41.696456),60655-20210112
60642,01/06/2021,36,855,25,833,0.042,11,22,0.001,19716,POINT (-87.657821 41.899935),60642-20210106
60629,01/09/2021,60,929,31,827,0.008,29,102,0.001,110029,POINT (-87.711565 41.777061),60629-20210109
Unknown,12/25/2020,0,38,0,38,0,0,0,0,0,,Unknown-20201225
60640,01/02/2021,34,1228,34,1228,0.018,0,0,0,69363,POINT (-87.662232 41.971888),60640-20210102
60645,01/16/2021,33,1822,29,1552,0.033,4,270,0.006,47270,POINT (-87.695049 42.008927),60645-20210116
60666,01/08/2021,0,0,0,0,0,0,0,0,0,POINT (-87.896371 41.979511),60666-20210108
60620,12/29/2020,32,192,32,192,0.003,0,0,0,67711,POINT (-87.651656 41.740873),60620-20201229
60624,12/27/2020,0,59,0,59,0.002,0,0,0,34892,POINT (-87.722735 41.879417),60624-20201227
60605,12/22/2020,218,1033,218,1033,0.036,0,0,0,29060,POINT (-87.623449 41.867824),60605-20201222
60618,12/25/2020,0,917,0,917,0.01,0,0,0,94907,POINT (-87.703343 41.946699),60618-20201225
60649,12/23/2020,26,106,26,106,0.002,0,0,0,46633,POINT (-87.571522 41.762202),60649-20201223
60649,12/17/2020,13,13,13,13,0,0,0,0,46633,POINT (-87.571522 41.762202),60649-20201217
60645,12/16/2020,5,5,5,5,0,0,0,0,47270,POINT (-87.695049 42.008927),60645-20201216
60652,12/26/2020,2,156,2,156,0.004,0,0,0,43447,POINT (-87.714238 41.745398),60652-20201226
60653,12/23/2020,27,160,27,160,0.005,0,0,0,33154,POINT (-87.611244 41.819261),60653-20201223
60630,01/05/2021,154,906,152,902,0.016,2,4,0,56433,POINT (-87.759611 41.971261),60630-20210105
60653,01/26/2021,98,1609,76,1318,0.04,22,291,0.009,33154,POINT (-87.611244 41.819261),60653-20210126
60643,12/24/2020,10,311,10,311,0.006,0,0,0,48887,POINT (-87.662381 41.700445),60643-20201224
60617,01/13/2021,66,910,40,737,0.009,26,173,0.002,83553,POINT (-87.556897 41.721257),60617-20210113
60619,01/18/2021,49,952,37,828,0.014,12,124,0.002,61207,POINT (-87.60569 41.744737),60619-20210118
60602,12/18/2020,7,8,7,8,0.007,0,0,0,1145,POINT (-87.628309 41.883136),60602-20201218
60666,02/11/2021,0,22,0,20,0,0,2,0,0,POINT (-87.896371 41.979511),60666-20210211
60623,01/08/2021,64,740,43,703,0.009,21,37,0,81283,POINT (-87.717446 41.850321),60623-20210108
60624,01/11/2021,19,266,12,234,0.007,7,32,0.001,34892,POINT (-87.722735 41.879417),60624-20210111
60633,12/18/2020,2,4,2,4,0,0,0,0,12689,POINT (-87.556037 41.653147),60633-20201218
60656,01/25/2021,54,1136,41,869,0.031,13,267,0.009,28218,POINT (-87.817934 41.974566),60656-20210125
60641,01/06/2021,89,984,60,955,0.014,29,29,0,69880,POINT (-87.746791 41.946682),60641-20210106
Unknown,01/26/2021,45,749,31,645,0,14,104,0,0,,Unknown-20210126
60621,01/04/2021,8,188,8,188,0.007,0,0,0,28018,POINT (-87.638812 41.776931),60621-20210104
60645,12/15/2020,0,0,0,0,0,0,0,0,47270,POINT (-87.695049 42.008927),60645-20201215
60656,12/24/2020,2,194,2,194,0.007,0,0,0,28218,POINT (-87.817934 41.974566),60656-20201224
60657,12/21/2020,281,1047,281,1047,0.015,0,0,0,70958,POINT (-87.658216 41.939715),60657-20201221
Unknown,12/30/2020,24,84,24,84,0,0,0,0,0,,Unknown-20201230
60606,12/26/2020,1,91,1,91,0.028,0,0,0,3287,POINT (-87.63676 41.882634),60606-20201226
60645,12/27/2020,0,288,0,288,0.006,0,0,0,47270,POINT (-87.695049 42.008927),60645-20201227
60827,12/25/2020,0,7,0,7,0,0,0,0,28483,POINT (-87.633087 41.650765),60827-20201225
60601,12/31/2020,14,414,14,414,0.027,0,0,0,15083,POINT (-87.622844 41.886262),60601-20201231
60617,12/29/2020,49,291,49,291,0.003,0,0,0,83553,POINT (-87.556897 41.721257),60617-20201229
60610,12/24/2020,21,643,21,643,0.016,0,0,0,40548,POINT (-87.63581 41.90455),60610-20201224
60629,01/19/2021,111,1680,65,1349,0.012,46,331,0.003,110029,POINT (-87.711565 41.777061),60629-20210119
60612,12/28/2020,58,585,58,585,0.017,0,0,0,33735,POINT (-87.687011 41.88004),60612-20201228
60657,12/31/2020,59,2065,59,2065,0.029,0,0,0,70958,POINT (-87.658216 41.939715),60657-20201231
60655,12/17/2020,41,41,41,41,0.001,0,0,0,28569,POINT (-87.701434 41.696456),60655-20201217
60661,01/18/2021,25,1087,13,734,0.071,12,353,0.034,10354,POINT (-87.644283 41.882786),60661-20210118
60631,12/28/2020,16,363,16,363,0.012,0,0,0,29529,POINT (-87.813371 41.995019),60631-20201228
60614,12/23/2020,100,1252,100,1252,0.017,0,0,0,71954,POINT (-87.652064 41.922605),60614-20201223
60660,01/03/2021,27,632,27,632,0.014,0,0,0,44498,POINT (-87.666362 41.991062),60660-20210103
60652,01/02/2021,12,393,12,393,0.009,0,0,0,43447,POINT (-87.714238 41.745398),60652-20210102
60707,12/22/2020,14,56,14,56,0.001,0,0,0,43093,POINT (-87.808283 41.921777),60707-20201222
60620,01/03/2021,8,271,7,270,0.004,1,1,0,67711,POINT (-87.651656 41.740873),60620-20210103
60608,12/30/2020,141,845,141,845,0.011,0,0,0,80059,POINT (-87.670366 41.849879),60608-20201230
Unknown,01/31/2021,2,950,2,813,0,0,137,0,0,,Unknown-20210131
60639,01/17/2021,8,1367,6,1161,0.013,2,206,0.002,88204,POINT (-87.75531 41.920609),60639-20210117
Unknown,01/09/2021,12,151,11,143,0,1,8,0,0,,Unknown-20210109
60636,12/31/2020,9,83,9,83,0.003,0,0,0,30024,POINT (-87.668597 41.77599),60636-20201231
60606,01/02/2021,6,129,6,129,0.039,0,0,0,3287,POINT (-87.63676 41.882634),60606-20210102
60661,01/08/2021,91,721,22,592,0.057,69,129,0.012,10354,POINT (-87.644283 41.882786),60661-20210108
Unknown,02/05/2021,77,1208,33,938,0,44,270,0,0,,Unknown-20210205
60608,01/06/2021,71,1173,58,1150,0.014,13,23,0,80059,POINT (-87.670366 41.849879),60608-20210106
60610,12/15/2020,0,0,0,0,0,0,0,0,40548,POINT (-87.63581 41.90455),60610-20201215
60639,01/02/2021,22,400,22,400,0.005,0,0,0,88204,POINT (-87.75531 41.920609),60639-20210102
60625,12/17/2020,33,37,33,37,0,0,0,0,79444,POINT (-87.701816 41.971155),60625-20201217
60645,12/28/2020,32,320,32,320,0.007,0,0,0,47270,POINT (-87.695049 42.008927),60645-20201228
60606,01/23/2021,13,373,11,251,0.076,2,122,0.037,3287,POINT (-87.63676 41.882634),60606-20210123
60609,01/16/2021,82,1047,77,866,0.014,5,181,0.003,60939,POINT (-87.653382 41.812017),60609-20210116
60666,01/23/2021,0,2,0,2,0,0,0,0,0,POINT (-87.896371 41.979511),60666-20210123
60628,12/30/2020,37,215,37,215,0.003,0,0,0,64254,POINT (-87.621537 41.694192),60628-20201230
60649,01/07/2021,40,438,23,416,0.009,17,22,0,46633,POINT (-87.571522 41.762202),60649-20210107
60653,01/07/2021,42,531,27,503,0.015,15,28,0.001,33154,POINT (-87.611244 41.819261),60653-20210107
60657,01/15/2021,179,5088,153,3672,0.052,26,1416,0.02,70958,POINT (-87.658216 41.939715),60657-20210115
60657,12/16/2020,10,10,10,10,0,0,0,0,70958,POINT (-87.658216 41.939715),60657-20201216
60660,01/16/2021,64,2311,58,1975,0.044,6,336,0.008,44498,POINT (-87.666362 41.991062),60660-20210116
60621,12/20/2020,3,18,3,18,0.001,0,0,0,28018,POINT (-87.638812 41.776931),60621-20201220
60629,12/25/2020,0,277,0,277,0.003,0,0,0,110029,POINT (-87.711565 41.777061),60629-20201225
60620,12/17/2020,16,16,16,16,0,0,0,0,67711,POINT (-87.651656 41.740873),60620-20201217
60652,01/17/2021,6,886,5,740,0.017,1,146,0.003,43447,POINT (-87.714238 41.745398),60652-20210117
60611,12/18/2020,515,702,515,702,0.021,0,0,0,33224,POINT (-87.620291 41.894734),60611-20201218
60620,12/19/2020,12,66,12,66,0.001,0,0,0,67711,POINT (-87.651656 41.740873),60620-20201219
60827,12/18/2020,4,4,4,4,0,0,0,0,28483,POINT (-87.633087 41.650765),60827-20201218
60601,01/15/2021,32,974,21,677,0.045,11,297,0.02,15083,POINT (-87.622844 41.886262),60601-20210115
60622,12/29/2020,259,1697,259,1697,0.032,0,0,0,53294,POINT (-87.681818 41.902762),60622-20201229
60638,12/22/2020,53,277,53,277,0.005,0,0,0,58669,POINT (-87.771902 41.787032),60638-20201222
60632,12/29/2020,54,242,54,242,0.003,0,0,0,89857,POINT (-87.711251 41.810038),60632-20201229
60651,12/19/2020,13,46,13,46,0.001,0,0,0,63492,POINT (-87.741017 41.901964),60651-20201219
60642,12/19/2020,78,265,78,265,0.013,0,0,0,19716,POINT (-87.657821 41.899935),60642-20201219
60625,12/22/2020,67,500,67,500,0.006,0,0,0,79444,POINT (-87.701816 41.971155),60625-20201222
60610,01/08/2021,273,1565,102,1286,0.032,171,279,0.007,40548,POINT (-87.63581 41.90455),60610-20210108
60628,01/22/2021,110,1254,103,1064,0.017,7,190,0.003,64254,POINT (-87.621537 41.694192),60628-20210122
60606,12/31/2020,5,123,5,123,0.037,0,0,0,3287,POINT (-87.63676 41.882634),60606-20201231
60653,01/19/2021,91,1091,69,885,0.027,22,206,0.006,33154,POINT (-87.611244 41.819261),60653-20210119
60707,12/19/2020,8,25,8,25,0.001,0,0,0,43093,POINT (-87.808283 41.921777),60707-20201219
60636,01/17/2021,3,245,3,218,0.007,0,27,0.001,30024,POINT (-87.668597 41.77599),60636-20210117
60657,01/12/2021,371,4517,188,3288,0.046,183,1229,0.017,70958,POINT (-87.658216 41.939715),60657-20210112
60636,12/16/2020,0,0,0,0,0,0,0,0,30024,POINT (-87.668597 41.77599),60636-20201216
Unknown,02/06/2021,38,1246,14,952,0,24,294,0,0,,Unknown-20210206
60625,12/15/2020,0,0,0,0,0,0,0,0,79444,POINT (-87.701816 41.971155),60625-20201215
60630,12/25/2020,0,425,0,425,0.008,0,0,0,56433,POINT (-87.759611 41.971261),60630-20201225
60640,12/26/2020,17,742,17,742,0.011,0,0,0,69363,POINT (-87.662232 41.971888),60640-20201226
60620,12/20/2020,3,69,3,69,0.001,0,0,0,67711,POINT (-87.651656 41.740873),60620-20201220
60621,12/19/2020,6,15,6,15,0.001,0,0,0,28018,POINT (-87.638812 41.776931),60621-20201219
60622,12/24/2020,25,1360,25,1360,0.026,0,0,0,53294,POINT (-87.681818 41.902762),60622-20201224
60632,01/19/2021,95,1214,62,1007,0.011,33,207,0.002,89857,POINT (-87.711251 41.810038),60632-20210119
60624,12/28/2020,6,65,6,65,0.002,0,0,0,34892,POINT (-87.722735 41.879417),60624-20201228
60639,12/31/2020,40,378,40,378,0.004,0,0,0,88204,POINT (-87.75531 41.920609),60639-20201231
60622,01/12/2021,272,4079,109,2958,0.056,163,1121,0.021,53294,POINT (-87.681818 41.902762),60622-20210112
60645,01/07/2021,109,1143,69,1093,0.023,40,50,0.001,47270,POINT (-87.695049 42.008927),60645-20210107
60617,01/12/2021,87,844,57,697,0.008,30,147,0.002,83553,POINT (-87.556897 41.721257),60617-20210112
60643,01/03/2021,13,482,12,481,0.01,1,1,0,48887,POINT (-87.662381 41.700445),60643-20210103
60629,01/05/2021,55,657,53,654,0.006,2,3,0,110029,POINT (-87.711565 41.777061),60629-20210105
60601,12/26/2020,10,317,10,317,0.021,0,0,0,15083,POINT (-87.622844 41.886262),60601-20201226
60642,12/30/2020,68,670,68,670,0.034,0,0,0,19716,POINT (-87.657821 41.899935),60642-20201230
60623,01/03/2021,7,414,7,414,0.005,0,0,0,81283,POINT (-87.717446 41.850321),60623-20210103
60633,01/30/2021,24,414,20,341,0.027,4,73,0.006,12689,POINT (-87.556037 41.653147),60633-20210130
60655,01/08/2021,90,985,20,800,0.028,70,185,0.006,28569,POINT (-87.701434 41.696456),60655-20210108
60612,01/07/2021,102,1098,44,1028,0.03,58,70,0.002,33735,POINT (-87.687011 41.88004),60612-20210107
60602,12/23/2020,4,28,4,28,0.024,0,0,0,1145,POINT (-87.628309 41.883136),60602-20201223
60618,12/21/2020,179,629,179,629,0.007,0,0,0,94907,POINT (-87.703343 41.946699),60618-20201221
60616,01/02/2021,11,929,11,929,0.017,0,0,0,54197,POINT (-87.629531 41.844869),60616-20210102
60607,12/17/2020,100,105,100,105,0.004,0,0,0,29293,POINT (-87.652727 41.876104),60607-20201217
60628,12/21/2020,20,64,20,64,0.001,0,0,0,64254,POINT (-87.621537 41.694192),60628-20201221
60630,12/20/2020,19,229,19,229,0.004,0,0,0,56433,POINT (-87.759611 41.971261),60630-20201220
60652,12/31/2020,20,381,20,381,0.009,0,0,0,43447,POINT (-87.714238 41.745398),60652-20201231
60651,12/20/2020,4,50,4,50,0.001,0,0,0,63492,POINT (-87.741017 41.901964),60651-20201220
60645,01/18/2021,57,1895,43,1609,0.034,14,286,0.006,47270,POINT (-87.695049 42.008927),60645-20210118
60610,01/03/2021,9,944,8,943,0.023,1,1,0,40548,POINT (-87.63581 41.90455),60610-20210103
60649,12/27/2020,0,121,0,121,0.003,0,0,0,46633,POINT (-87.571522 41.762202),60649-20201227
60631,01/09/2021,66,1122,10,914,0.031,56,208,0.007,29529,POINT (-87.813371 41.995019),60631-20210109
60643,01/08/2021,90,865,32,733,0.015,58,132,0.003,48887,POINT (-87.662381 41.700445),60643-20210108
60707,01/20/2021,41,473,27,376,0.009,14,97,0.002,43093,POINT (-87.808283 41.921777),60707-20210120
60661,12/15/2020,0,0,0,0,0,0,0,0,10354,POINT (-87.644283 41.882786),60661-20201215
60638,01/10/2021,20,958,6,789,0.013,14,169,0.003,58669,POINT (-87.771902 41.787032),60638-20210110
60656,01/08/2021,65,496,17,404,0.014,48,92,0.003,28218,POINT (-87.817934 41.974566),60656-20210108
60620,01/08/2021,83,616,56,555,0.008,27,61,0.001,67711,POINT (-87.651656 41.740873),60620-20210108
60626,01/01/2021,0,746,0,746,0.015,0,0,0,50544,POINT (-87.669834 42.009469),60626-20210101
60632,01/04/2021,48,470,47,469,0.005,1,1,0,89857,POINT (-87.711251 41.810038),60632-20210104
60641,12/18/2020,93,144,93,144,0.002,0,0,0,69880,POINT (-87.746791 41.946682),60641-20201218
60656,01/04/2021,30,336,30,336,0.012,0,0,0,28218,POINT (-87.817934 41.974566),60656-20210104
60614,12/28/2020,101,1422,101,1422,0.02,0,0,0,71954,POINT (-87.652064 41.922605),60614-20201228
60623,12/28/2020,93,252,93,252,0.003,0,0,0,81283,POINT (-87.717446 41.850321),60623-20201228
60633,01/13/2021,9,122,6,100,0.008,3,22,0.002,12689,POINT (-87.556037 41.653147),60633-20210113
60608,01/01/2021,0,912,0,912,0.011,0,0,0,80059,POINT (-87.670366 41.849879),60608-20210101
60660,01/06/2021,80,881,68,864,0.019,12,17,0,44498,POINT (-87.666362 41.991062),60660-20210106
60666,12/15/2020,0,0,0,0,0,0,0,0,0,POINT (-87.896371 41.979511),60666-20201215
60666,01/20/2021,0,2,0,2,0,0,0,0,0,POINT (-87.896371 41.979511),60666-20210120
60641,01/10/2021,19,1315,11,1098,0.016,8,217,0.003,69880,POINT (-87.746791 41.946682),60641-20210110
60644,12/17/2020,4,4,4,4,0,0,0,0,46591,POINT (-87.756863 41.881113),60644-20201217
60609,01/11/2021,51,746,17,640,0.011,34,106,0.002,60939,POINT (-87.653382 41.812017),60609-20210111
60660,12/16/2020,2,2,2,2,0,0,0,0,44498,POINT (-87.666362 41.991062),60660-20201216
60653,01/04/2021,19,430,18,429,0.013,1,1,0,33154,POINT (-87.611244 41.819261),60653-20210104
60608,01/18/2021,93,2569,57,2002,0.025,36,567,0.007,80059,POINT (-87.670366 41.849879),60608-20210118
60608,12/17/2020,35,35,35,35,0,0,0,0,80059,POINT (-87.670366 41.849879),60608-20201217
60630,01/09/2021,75,1327,21,1104,0.02,54,223,0.004,56433,POINT (-87.759611 41.971261),60630-20210109
60651,12/31/2020,18,237,18,237,0.004,0,0,0,63492,POINT (-87.741017 41.901964),60651-20201231
60827,01/29/2021,5,74,4,63,0.002,1,11,0,28483,POINT (-87.633087 41.650765),60827-20210129
60666,12/20/2020,0,0,0,0,0,0,0,0,0,POINT (-87.896371 41.979511),60666-20201220
60647,12/17/2020,87,95,87,95,0.001,0,0,0,87633,POINT (-87.701101 41.921058),60647-20201217
60619,01/12/2021,50,604,37,524,0.009,13,80,0.001,61207,POINT (-87.60569 41.744737),60619-20210112
60628,01/05/2021,24,397,24,396,0.006,0,1,0,64254,POINT (-87.621537 41.694192),60628-20210105
60649,12/20/2020,2,49,2,49,0.001,0,0,0,46633,POINT (-87.571522 41.762202),60649-20201220
60645,12/23/2020,36,272,36,272,0.006,0,0,0,47270,POINT (-87.695049 42.008927),60645-20201223
60625,01/01/2021,1,990,1,990,0.012,0,0,0,79444,POINT (-87.701816 41.971155),60625-20210101
60602,01/07/2021,2,63,0,60,0.052,2,3,0.003,1145,POINT (-87.628309 41.883136),60602-20210107
60632,01/13/2021,61,879,41,750,0.008,20,129,0.001,89857,POINT (-87.711251 41.810038),60632-20210113
60619,12/20/2020,4,49,4,49,0.001,0,0,0,61207,POINT (-87.60569 41.744737),60619-20201220
60637,01/17/2021,16,1710,0,1278,0.027,16,432,0.009,47300,POINT (-87.604053 41.780991),60637-20210117
60661,12/28/2020,14,373,14,373,0.036,0,0,0,10354,POINT (-87.644283 41.882786),60661-20201228
60639,12/21/2020,42,132,42,132,0.001,0,0,0,88204,POINT (-87.75531 41.920609),60639-20201221
60616,12/31/2020,35,916,35,916,0.017,0,0,0,54197,POINT (-87.629531 41.844869),60616-20201231
60609,12/27/2020,0,182,0,182,0.003,0,0,0,60939,POINT (-87.653382 41.812017),60609-20201227
60661,01/12/2021,57,917,19,627,0.061,38,290,0.028,10354,POINT (-87.644283 41.882786),60661-20210112
60637,01/02/2021,7,626,7,626,0.013,0,0,0,47300,POINT (-87.604053 41.780991),60637-20210102
60610,12/20/2020,24,347,24,347,0.009,0,0,0,40548,POINT (-87.63581 41.90455),60610-20201220
60623,12/19/2020,12,50,12,50,0.001,0,0,0,81283,POINT (-87.717446 41.850321),60623-20201219
60639,01/05/2021,64,541,63,537,0.006,1,4,0,88204,POINT (-87.75531 41.920609),60639-20210105
60620,12/15/2020,0,0,0,0,0,0,0,0,67711,POINT (-87.651656 41.740873),60620-20201215
60666,01/25/2021,1,3,1,3,0,0,0,0,0,POINT (-87.896371 41.979511),60666-20210125
60827,12/28/2020,0,7,0,7,0,0,0,0,28483,POINT (-87.633087 41.650765),60827-20201228
60637,12/26/2020,4,363,4,363,0.008,0,0,0,47300,POINT (-87.604053 41.780991),60637-20201226
60657,01/02/2021,64,2133,64,2133,0.03,0,0,0,70958,POINT (-87.658216 41.939715),60657-20210102
60643,01/15/2021,67,1534,60,1236,0.025,7,298,0.006,48887,POINT (-87.662381 41.700445),60643-20210115
60644,01/18/2021,18,965,11,885,0.019,7,80,0.002,46591,POINT (-87.756863 41.881113),60644-20210118
60649,01/11/2021,83,697,69,633,0.014,14,64,0.001,46633,POINT (-87.571522 41.762202),60649-20210111
60639,12/16/2020,3,3,3,3,0,0,0,0,88204,POINT (-87.75531 41.920609),60639-20201216
60621,12/24/2020,1,33,1,33,0.001,0,0,0,28018,POINT (-87.638812 41.776931),60621-20201224
60614,12/27/2020,2,1321,2,1321,0.018,0,0,0,71954,POINT (-87.652064 41.922605),60614-20201227
60644,01/03/2021,7,306,7,306,0.007,0,0,0,46591,POINT (-87.756863 41.881113),60644-20210103
60631,12/25/2020,0,341,0,341,0.012,0,0,0,29529,POINT (-87.813371 41.995019),60631-20201225
60629,12/21/2020,46,168,46,168,0.002,0,0,0,110029,POINT (-87.711565 41.777061),60629-20201221
60630,12/30/2020,74,606,74,606,0.011,0,0,0,56433,POINT (-87.759611 41.971261),60630-20201230
60613,12/18/2020,210,266,210,266,0.005,0,0,0,50761,POINT (-87.661343 41.953742),60613-20201218
60618,01/04/2021,141,1638,132,1626,0.017,9,12,0,94907,POINT (-87.703343 41.946699),60618-20210104
60707,01/01/2021,0,120,0,120,0.003,0,0,0,43093,POINT (-87.808283 41.921777),60707-20210101
60652,01/15/2021,29,854,23,716,0.016,6,138,0.003,43447,POINT (-87.714238 41.745398),60652-20210115
60633,12/29/2020,7,37,7,37,0.003,0,0,0,12689,POINT (-87.556037 41.653147),60633-20201229
Unknown,01/05/2021,13,107,13,107,0,0,0,0,0,,Unknown-20210105
60666,12/24/2020,0,0,0,0,0,0,0,0,0,POINT (-87.896371 41.979511),60666-20201224
60660,12/24/2020,11,342,11,342,0.008,0,0,0,44498,POINT (-87.666362 41.991062),60660-20201224
60641,12/26/2020,13,442,13,442,0.006,0,0,0,69880,POINT (-87.746791 41.946682),60641-20201226
60827,01/01/2021,0,9,0,9,0,0,0,0,28483,POINT (-87.633087 41.650765),60827-20210101
60610,12/27/2020,0,658,0,658,0.016,0,0,0,40548,POINT (-87.63581 41.90455),60610-20201227
60666,01/13/2021,1,1,1,1,0,0,0,0,0,POINT (-87.896371 41.979511),60666-20210113
60645,01/03/2021,12,672,12,672,0.014,0,0,0,47270,POINT (-87.695049 42.008927),60645-20210103
60616,12/16/2020,3,3,3,3,0,0,0,0,54197,POINT (-87.629531 41.844869),60616-20201216
60638,01/17/2021,15,1399,13,1071,0.018,2,328,0.006,58669,POINT (-87.771902 41.787032),60638-20210117
60643,01/18/2021,64,1668,52,1350,0.028,12,318,0.007,48887,POINT (-87.662381 41.700445),60643-20210118
60640,01/22/2021,233,5419,207,4395,0.063,26,1024,0.015,69363,POINT (-87.662232 41.971888),60640-20210122
60616,12/18/2020,158,221,158,221,0.004,0,0,0,54197,POINT (-87.629531 41.844869),60616-20201218
60609,12/20/2020,12,72,12,72,0.001,0,0,0,60939,POINT (-87.653382 41.812017),60609-20201220
60660,01/12/2021,119,1991,83,1720,0.039,36,271,0.006,44498,POINT (-87.666362 41.991062),60660-20210112
60640,01/05/2021,143,1667,136,1653,0.024,7,14,0,69363,POINT (-87.662232 41.971888),60640-20210105
60624,12/19/2020,5,23,5,23,0.001,0,0,0,34892,POINT (-87.722735 41.879417),60624-20201219
60628,12/25/2020,0,111,0,111,0.002,0,0,0,64254,POINT (-87.621537 41.694192),60628-20201225
Unknown,12/28/2020,2,43,2,43,0,0,0,0,0,,Unknown-20201228
60638,12/26/2020,5,327,5,327,0.006,0,0,0,58669,POINT (-87.771902 41.787032),60638-20201226
Unknown,02/02/2021,42,1005,20,844,0,22,161,0,0,,Unknown-20210202
60636,01/07/2021,15,141,12,136,0.005,3,5,0,30024,POINT (-87.668597 41.77599),60636-20210107
60601,01/10/2021,12,715,3,560,0.037,9,155,0.01,15083,POINT (-87.622844 41.886262),60601-20210110
60624,12/24/2020,1,58,1,58,0.002,0,0,0,34892,POINT (-87.722735 41.879417),60624-20201224
60618,12/28/2020,71,1013,71,1013,0.011,0,0,0,94907,POINT (-87.703343 41.946699),60618-20201228
60605,12/17/2020,123,134,123,134,0.005,0,0,0,29060,POINT (-87.623449 41.867824),60605-20201217
60653,01/16/2021,12,956,10,790,0.024,2,166,0.005,33154,POINT (-87.611244 41.819261),60653-20210116
60606,01/15/2021,8,270,7,182,0.055,1,88,0.027,3287,POINT (-87.63676 41.882634),60606-20210115
60657,12/23/2020,146,1398,146,1398,0.02,0,0,0,70958,POINT (-87.658216 41.939715),60657-20201223
60655,01/04/2021,18,686,17,685,0.024,1,1,0,28569,POINT (-87.701434 41.696456),60655-20210104
60655,01/19/2021,57,1579,47,1195,0.042,10,384,0.013,28569,POINT (-87.701434 41.696456),60655-20210119
60626,01/13/2021,96,1802,56,1510,0.03,40,292,0.006,50544,POINT (-87.669834 42.009469),60626-20210113
60607,12/21/2020,143,684,143,684,0.023,0,0,0,29293,POINT (-87.652727 41.876104),60607-20201221
60630,01/14/2021,92,1771,76,1368,0.024,16,403,0.007,56433,POINT (-87.759611 41.971261),60630-20210114
60633,01/04/2021,5,59,5,59,0.005,0,0,0,12689,POINT (-87.556037 41.653147),60633-20210104
60629,01/01/2021,0,523,0,523,0.005,0,0,0,110029,POINT (-87.711565 41.777061),60629-20210101
60827,01/20/2021,3,42,2,36,0.001,1,6,0,28483,POINT (-87.633087 41.650765),60827-20210120
60633,01/26/2021,26,292,19,233,0.018,7,59,0.005,12689,POINT (-87.556037 41.653147),60633-20210126
60666,01/30/2021,0,9,0,9,0,0,0,0,0,POINT (-87.896371 41.979511),60666-20210130
60607,01/01/2021,1,1412,1,1412,0.048,0,0,0,29293,POINT (-87.652727 41.876104),60607-20210101
60620,01/12/2021,62,734,39,623,0.009,23,111,0.002,67711,POINT (-87.651656 41.740873),60620-20210112
60636,01/02/2021,4,87,4,87,0.003,0,0,0,30024,POINT (-87.668597 41.77599),60636-20210102
60612,01/11/2021,119,1429,25,1123,0.033,94,306,0.009,33735,POINT (-87.687011 41.88004),60612-20210111
60657,12/18/2020,352,494,352,494,0.007,0,0,0,70958,POINT (-87.658216 41.939715),60657-20201218
60642,01/14/2021,36,1539,20,1047,0.053,16,492,0.025,19716,POINT (-87.657821 41.899935),60642-20210114
60607,01/18/2021,88,3383,46,2357,0.08,42,1026,0.035,29293,POINT (-87.652727 41.876104),60607-20210118
60651,12/27/2020,0,115,0,115,0.002,0,0,0,63492,POINT (-87.741017 41.901964),60651-20201227
60707,12/29/2020,17,98,17,98,0.002,0,0,0,43093,POINT (-87.808283 41.921777),60707-20201229
Unknown,12/19/2020,1,9,1,9,0,0,0,0,0,,Unknown-20201219
60601,01/07/2021,56,573,17,523,0.035,39,50,0.003,15083,POINT (-87.622844 41.886262),60601-20210107
60625,01/06/2021,177,1609,164,1589,0.02,13,20,0,79444,POINT (-87.701816 41.971155),60625-20210106
60638,01/06/2021,37,704,31,691,0.012,6,13,0,58669,POINT (-87.771902 41.787032),60638-20210106
60640,01/10/2021,32,2782,17,2443,0.035,15,339,0.005,69363,POINT (-87.662232 41.971888),60640-20210110
60653,12/28/2020,23,192,23,192,0.006,0,0,0,33154,POINT (-87.611244 41.819261),60653-20201228
60641,12/30/2020,77,640,77,640,0.009,0,0,0,69880,POINT (-87.746791 41.946682),60641-20201230
60651,12/15/2020,0,0,0,0,0,0,0,0,63492,POINT (-87.741017 41.901964),60651-20201215
60633,01/09/2021,1,98,1,87,0.007,0,11,0.001,12689,POINT (-87.556037 41.653147),60633-20210109
60601,12/23/2020,29,298,29,298,0.02,0,0,0,15083,POINT (-87.622844 41.886262),60601-20201223
60631,12/20/2020,25,207,25,207,0.007,0,0,0,29529,POINT (-87.813371 41.995019),60631-20201220
60602,12/26/2020,0,30,0,30,0.026,0,0,0,1145,POINT (-87.628309 41.883136),60602-20201226
60617,12/21/2020,34,116,34,116,0.001,0,0,0,83553,POINT (-87.556897 41.721257),60617-20201221
60624,01/03/2021,1,125,1,125,0.004,0,0,0,34892,POINT (-87.722735 41.879417),60624-20210103
60628,01/09/2021,20,555,16,509,0.008,4,46,0.001,64254,POINT (-87.621537 41.694192),60628-20210109
60640,12/31/2020,58,1192,58,1192,0.017,0,0,0,69363,POINT (-87.662232 41.971888),60640-20201231
60623,01/16/2021,26,1141,22,999,0.012,4,142,0.002,81283,POINT (-87.717446 41.850321),60623-20210116
60608,01/14/2021,123,2320,98,1805,0.023,25,515,0.006,80059,POINT (-87.670366 41.849879),60608-20210114
60633,02/10/2021,53,733,30,600,0.047,23,133,0.01,12689,POINT (-87.556037 41.653147),60633-20210210
60640,01/15/2021,131,3969,121,3264,0.047,10,705,0.01,69363,POINT (-87.662232 41.971888),60640-20210115
60644,01/08/2021,36,635,25,614,0.013,11,21,0,46591,POINT (-87.756863 41.881113),60644-20210108
60666,12/16/2020,0,0,0,0,0,0,0,0,0,POINT (-87.896371 41.979511),60666-20201216
60649,01/16/2021,13,1011,13,901,0.019,0,110,0.002,46633,POINT (-87.571522 41.762202),60649-20210116
60657,01/07/2021,300,3015,101,2744,0.039,199,271,0.004,70958,POINT (-87.658216 41.939715),60657-20210107
60656,12/18/2020,58,68,58,68,0.002,0,0,0,28218,POINT (-87.817934 41.974566),60656-20201218
60666,12/29/2020,0,0,0,0,0,0,0,0,0,POINT (-87.896371 41.979511),60666-20201229
60621,12/29/2020,12,106,12,106,0.004,0,0,0,28018,POINT (-87.638812 41.776931),60621-20201229
60641,01/14/2021,99,1799,79,1401,0.02,20,398,0.006,69880,POINT (-87.746791 41.946682),60641-20210114
60639,01/10/2021,84,884,79,786,0.009,5,98,0.001,88204,POINT (-87.75531 41.920609),60639-20210110
60621,01/12/2021,20,284,15,260,0.009,5,24,0.001,28018,POINT (-87.638812 41.776931),60621-20210112
60637,01/06/2021,107,935,91,892,0.019,16,43,0.001,47300,POINT (-87.604053 41.780991),60637-20210106
60643,12/31/2020,17,457,17,457,0.009,0,0,0,48887,POINT (-87.662381 41.700445),60643-20201231
60661,12/24/2020,11,351,11,351,0.034,0,0,0,10354,POINT (-87.644283 41.882786),60661-20201224
60707,01/13/2021,25,277,12,220,0.005,13,57,0.001,43093,POINT (-87.808283 41.921777),60707-20210113
Unknown,01/01/2021,0,87,0,87,0,0,0,0,0,,Unknown-20210101
60637,12/22/2020,79,256,79,256,0.005,0,0,0,47300,POINT (-87.604053 41.780991),60637-20201222
60626,12/22/2020,43,274,43,274,0.005,0,0,0,50544,POINT (-87.669834 42.009469),60626-20201222
60609,01/08/2021,50,647,25,597,0.01,25,50,0.001,60939,POINT (-87.653382 41.812017),60609-20210108
60618,01/12/2021,248,3085,128,2344,0.025,120,741,0.008,94907,POINT (-87.703343 41.946699),60618-20210112
60623,01/18/2021,39,1187,24,1030,0.013,15,157,0.002,81283,POINT (-87.717446 41.850321),60623-20210118
60649,01/06/2021,22,398,21,393,0.008,1,5,0,46633,POINT (-87.571522 41.762202),60649-20210106
60636,12/23/2020,7,28,7,28,0.001,0,0,0,30024,POINT (-87.668597 41.77599),60636-20201223
60614,12/15/2020,1,1,1,1,0,0,0,0,71954,POINT (-87.652064 41.922605),60614-20201215
60827,02/02/2021,7,91,5,76,0.003,2,15,0.001,28483,POINT (-87.633087 41.650765),60827-20210202
60609,01/21/2021,128,1399,106,1119,0.018,22,280,0.005,60939,POINT (-87.653382 41.812017),60609-20210121
60606,01/10/2021,3,205,0,156,0.047,3,49,0.015,3287,POINT (-87.63676 41.882634),60606-20210110
60633,02/05/2021,43,571,35,473,0.037,8,98,0.008,12689,POINT (-87.556037 41.653147),60633-20210205
60621,01/13/2021,14,298,10,270,0.01,4,28,0.001,28018,POINT (-87.638812 41.776931),60621-20210113
60666,02/14/2021,0,23,0,21,0,0,2,0,0,POINT (-87.896371 41.979511),60666-20210214
60639,12/26/2020,1,217,1,217,0.002,0,0,0,88204,POINT (-87.75531 41.920609),60639-20201226
60633,12/25/2020,0,26,0,26,0.002,0,0,0,12689,POINT (-87.556037 41.653147),60633-20201225
60661,01/16/2021,22,1056,17,717,0.069,5,339,0.033,10354,POINT (-87.644283 41.882786),60661-20210116
60633,01/19/2021,19,166,14,134,0.011,5,32,0.003,12689,POINT (-87.556037 41.653147),60633-20210119
60602,01/02/2021,0,44,0,44,0.038,0,0,0,1145,POINT (-87.628309 41.883136),60602-20210102
60617,01/05/2021,59,470,57,465,0.006,2,5,0,83553,POINT (-87.556897 41.721257),60617-20210105
60612,12/27/2020,0,527,0,527,0.016,0,0,0,33735,POINT (-87.687011 41.88004),60612-20201227
60619,12/24/2020,10,121,10,121,0.002,0,0,0,61207,POINT (-87.60569 41.744737),60619-20201224
60626,12/29/2020,59,422,59,422,0.008,0,0,0,50544,POINT (-87.669834 42.009469),60626-20201229
60633,01/03/2021,1,54,1,54,0.004,0,0,0,12689,POINT (-87.556037 41.653147),60633-20210103
60636,01/14/2021,12,224,10,199,0.007,2,25,0.001,30024,POINT (-87.668597 41.77599),60636-20210114
60655,01/16/2021,21,1466,15,1095,0.038,6,371,0.013,28569,POINT (-87.701434 41.696456),60655-20210116
60707,12/25/2020,0,75,0,75,0.002,0,0,0,43093,POINT (-87.808283 41.921777),60707-20201225
60642,01/05/2021,59,819,52,808,0.041,7,11,0.001,19716,POINT (-87.657821 41.899935),60642-20210105
60636,12/26/2020,2,32,2,32,0.001,0,0,0,30024,POINT (-87.668597 41.77599),60636-20201226
60638,01/02/2021,28,567,28,567,0.01,0,0,0,58669,POINT (-87.771902 41.787032),60638-20210102
60640,12/21/2020,140,471,140,471,0.007,0,0,0,69363,POINT (-87.662232 41.971888),60640-20201221
60622,12/19/2020,247,696,247,696,0.013,0,0,0,53294,POINT (-87.681818 41.902762),60622-20201219
60621,12/15/2020,0,0,0,0,0,0,0,0,28018,POINT (-87.638812 41.776931),60621-20201215
60640,01/01/2021,2,1194,2,1194,0.017,0,0,0,69363,POINT (-87.662232 41.971888),60640-20210101
60628,12/29/2020,35,178,35,178,0.003,0,0,0,64254,POINT (-87.621537 41.694192),60628-20201229
Unknown,12/24/2020,3,38,3,38,0,0,0,0,0,,Unknown-20201224
60638,12/30/2020,80,510,80,510,0.009,0,0,0,58669,POINT (-87.771902 41.787032),60638-20201230
60656,01/11/2021,40,582,9,427,0.015,31,155,0.005,28218,POINT (-87.817934 41.974566),60656-20210111
60614,12/16/2020,3,4,3,4,0,0,0,0,71954,POINT (-87.652064 41.922605),60614-20201216
60642,01/10/2021,30,1224,9,922,0.047,21,302,0.015,19716,POINT (-87.657821 41.899935),60642-20210110
60607,01/10/2021,30,2461,8,1924,0.066,22,537,0.018,29293,POINT (-87.652727 41.876104),60607-20210110
60616,12/22/2020,106,538,106,538,0.01,0,0,0,54197,POINT (-87.629531 41.844869),60616-20201222
60626,01/09/2021,65,1407,31,1249,0.025,34,158,0.003,50544,POINT (-87.669834 42.009469),60626-20210109
60645,01/15/2021,73,1789,69,1523,0.032,4,266,0.006,47270,POINT (-87.695049 42.008927),60645-20210115
60643,01/11/2021,82,1008,44,793,0.016,38,215,0.004,48887,POINT (-87.662381 41.700445),60643-20210111
60618,12/24/2020,38,917,38,917,0.01,0,0,0,94907,POINT (-87.703343 41.946699),60618-20201224
60827,01/05/2021,0,11,0,11,0,0,0,0,28483,POINT (-87.633087 41.650765),60827-20210105
60653,01/12/2021,90,800,65,670,0.02,25,130,0.004,33154,POINT (-87.611244 41.819261),60653-20210112
60614,12/18/2020,321,453,321,453,0.006,0,0,0,71954,POINT (-87.652064 41.922605),60614-20201218
60605,12/21/2020,175,815,175,815,0.028,0,0,0,29060,POINT (-87.623449 41.867824),60605-20201221
60651,12/22/2020,17,86,17,86,0.001,0,0,0,63492,POINT (-87.741017 41.901964),60651-20201222
60620,12/28/2020,25,160,25,160,0.002,0,0,0,67711,POINT (-87.651656 41.740873),60620-20201228
60666,01/01/2021,0,0,0,0,0,0,0,0,0,POINT (-87.896371 41.979511),60666-20210101
60601,01/14/2021,37,942,29,656,0.043,8,286,0.019,15083,POINT (-87.622844 41.886262),60601-20210114
60625,12/25/2020,0,627,0,627,0.008,0,0,0,79444,POINT (-87.701816 41.971155),60625-20201225
60656,12/15/2020,0,0,0,0,0,0,0,0,28218,POINT (-87.817934 41.974566),60656-20201215
60660,12/23/2020,43,331,43,331,0.007,0,0,0,44498,POINT (-87.666362 41.991062),60660-20201223
60607,01/05/2021,86,1694,74,1672,0.057,12,22,0.001,29293,POINT (-87.652727 41.876104),60607-20210105
60661,12/16/2020,7,7,7,7,0.001,0,0,0,10354,POINT (-87.644283 41.882786),60661-20201216
60631,01/04/2021,59,672,58,671,0.023,1,1,0,29529,POINT (-87.813371 41.995019),60631-20210104
60633,01/08/2021,7,97,6,86,0.007,1,11,0.001,12689,POINT (-87.556037 41.653147),60633-20210108
60621,01/07/2021,15,234,12,226,0.008,3,8,0,28018,POINT (-87.638812 41.776931),60621-20210107
60633,12/17/2020,2,2,2,2,0,0,0,0,12689,POINT (-87.556037 41.653147),60633-20201217
Unknown,12/29/2020,17,60,17,60,0,0,0,0,0,,Unknown-20201229
60623,01/12/2021,107,941,83,845,0.01,24,96,0.001,81283,POINT (-87.717446 41.850321),60623-20210112
60657,12/24/2020,50,1448,50,1448,0.02,0,0,0,70958,POINT (-87.658216 41.939715),60657-20201224
60601,01/03/2021,5,428,5,428,0.028,0,0,0,15083,POINT (-87.622844 41.886262),60601-20210103
60629,01/13/2021,105,1226,78,991,0.009,27,235,0.002,110029,POINT (-87.711565 41.777061),60629-20210113
60628,12/24/2020,10,111,10,111,0.002,0,0,0,64254,POINT (-87.621537 41.694192),60628-20201224
60610,01/11/2021,136,1836,32,1352,0.033,104,484,0.012,40548,POINT (-87.63581 41.90455),60610-20210111
60620,01/16/2021,21,895,18,758,0.011,3,137,0.002,67711,POINT (-87.651656 41.740873),60620-20210116
60656,01/29/2021,96,1489,85,1160,0.041,11,329,0.012,28218,POINT (-87.817934 41.974566),60656-20210129
60624,12/23/2020,8,57,8,57,0.002,0,0,0,34892,POINT (-87.722735 41.879417),60624-20201223
60655,12/18/2020,90,131,90,131,0.005,0,0,0,28569,POINT (-87.701434 41.696456),60655-20201218
60612,01/15/2021,103,1899,84,1392,0.041,19,507,0.015,33735,POINT (-87.687011 41.88004),60612-20210115
60660,12/28/2020,36,383,36,383,0.009,0,0,0,44498,POINT (-87.666362 41.991062),60660-20201228
Unknown,01/30/2021,25,948,16,811,0,9,137,0,0,,Unknown-20210130
60644,12/27/2020,0,85,0,85,0.002,0,0,0,46591,POINT (-87.756863 41.881113),60644-20201227
60652,12/22/2020,22,115,22,115,0.003,0,0,0,43447,POINT (-87.714238 41.745398),60652-20201222
60631,12/18/2020,85,108,85,108,0.004,0,0,0,29529,POINT (-87.813371 41.995019),60631-20201218
60606,12/21/2020,17,69,17,69,0.021,0,0,0,3287,POINT (-87.63676 41.882634),60606-20201221
60657,12/15/2020,0,0,0,0,0,0,0,0,70958,POINT (-87.658216 41.939715),60657-20201215
60601,12/19/2020,43,139,43,139,0.009,0,0,0,15083,POINT (-87.622844 41.886262),60601-20201219
60621,01/18/2021,11,331,8,297,0.011,3,34,0.001,28018,POINT (-87.638812 41.776931),60621-20210118
60606,01/22/2021,17,360,16,240,0.073,1,120,0.037,3287,POINT (-87.63676 41.882634),60606-20210122
60624,01/07/2021,26,212,15,200,0.006,11,12,0,34892,POINT (-87.722735 41.879417),60624-20210107
60637,01/09/2021,78,1184,24,997,0.021,54,187,0.004,47300,POINT (-87.604053 41.780991),60637-20210109
60608,01/10/2021,99,1727,88,1484,0.019,11,243,0.003,80059,POINT (-87.670366 41.849879),60608-20210110
60633,12/20/2020,1,10,1,10,0.001,0,0,0,12689,POINT (-87.556037 41.653147),60633-20201220
60622,01/03/2021,19,2144,18,2143,0.04,1,1,0,53294,POINT (-87.681818 41.902762),60622-20210103
60630,01/08/2021,147,1252,61,1083,0.019,86,169,0.003,56433,POINT (-87.759611 41.971261),60630-20210108
60606,01/05/2021,7,146,4,140,0.043,3,6,0.002,3287,POINT (-87.63676 41.882634),60606-20210105
60660,01/07/2021,652,1533,603,1467,0.033,49,66,0.001,44498,POINT (-87.666362 41.991062),60660-20210107
60639,01/14/2021,82,1239,69,1039,0.012,13,200,0.002,88204,POINT (-87.75531 41.920609),60639-20210114
60637,12/25/2020,0,359,0,359,0.008,0,0,0,47300,POINT (-87.604053 41.780991),60637-20201225
60657,01/03/2021,30,2163,29,2162,0.03,1,1,0,70958,POINT (-87.658216 41.939715),60657-20210103
60656,12/28/2020,17,214,17,214,0.008,0,0,0,28218,POINT (-87.817934 41.974566),60656-20201228
60602,12/30/2020,5,44,5,44,0.038,0,0,0,1145,POINT (-87.628309 41.883136),60602-20201230
Unknown,01/12/2021,38,197,29,175,0,9,22,0,0,,Unknown-20210112
60628,01/13/2021,55,681,34,585,0.009,21,96,0.001,64254,POINT (-87.621537 41.694192),60628-20210113
60827,12/19/2020,0,4,0,4,0,0,0,0,28483,POINT (-87.633087 41.650765),60827-20201219
60643,12/27/2020,1,313,1,313,0.006,0,0,0,48887,POINT (-87.662381 41.700445),60643-20201227
60625,01/09/2021,107,2087,44,1790,0.023,63,297,0.004,79444,POINT (-87.701816 41.971155),60625-20210109
60645,12/31/2020,44,646,44,646,0.014,0,0,0,47270,POINT (-87.695049 42.008927),60645-20201231
60619,01/04/2021,33,313,31,311,0.005,2,2,0,61207,POINT (-87.60569 41.744737),60619-20210104
60623,12/17/2020,10,12,10,12,0,0,0,0,81283,POINT (-87.717446 41.850321),60623-20201217
60617,01/16/2021,29,1117,24,920,0.011,5,197,0.002,83553,POINT (-87.556897 41.721257),60617-20210116
60633,02/09/2021,36,680,31,570,0.045,5,110,0.009,12689,POINT (-87.556037 41.653147),60633-20210209
60640,01/20/2021,319,4701,240,3760,0.054,79,941,0.014,69363,POINT (-87.662232 41.971888),60640-20210120
60649,01/17/2021,5,1016,4,905,0.019,1,111,0.002,46633,POINT (-87.571522 41.762202),60649-20210117
60827,02/06/2021,3,116,2,96,0.003,1,20,0.001,28483,POINT (-87.633087 41.650765),60827-20210206
60617,12/24/2020,10,199,10,199,0.002,0,0,0,83553,POINT (-87.556897 41.721257),60617-20201224
60621,12/23/2020,4,32,4,32,0.001,0,0,0,28018,POINT (-87.638812 41.776931),60621-20201223
60651,01/01/2021,0,237,0,237,0.004,0,0,0,63492,POINT (-87.741017 41.901964),60651-20210101
60607,12/31/2020,61,1411,61,1411,0.048,0,0,0,29293,POINT (-87.652727 41.876104),60607-20201231
60645,01/10/2021,15,1324,8,1179,0.025,7,145,0.003,47270,POINT (-87.695049 42.008927),60645-20210110
60631,01/19/2021,96,1705,79,1347,0.046,17,358,0.012,29529,POINT (-87.813371 41.995019),60631-20210119
60652,01/06/2021,21,491,15,483,0.011,6,8,0,43447,POINT (-87.714238 41.745398),60652-20210106
60616,12/15/2020,0,0,0,0,0,0,0,0,54197,POINT (-87.629531 41.844869),60616-20201215
60624,12/16/2020,1,1,1,1,0,0,0,0,34892,POINT (-87.722735 41.879417),60624-20201216
60666,02/02/2021,2,12,2,12,0,0,0,0,0,POINT (-87.896371 41.979511),60666-20210202
60609,01/04/2021,30,375,30,375,0.006,0,0,0,60939,POINT (-87.653382 41.812017),60609-20210104
60612,12/31/2020,33,798,33,798,0.024,0,0,0,33735,POINT (-87.687011 41.88004),60612-20201231
60619,12/28/2020,32,153,32,153,0.002,0,0,0,61207,POINT (-87.60569 41.744737),60619-20201228
60652,01/21/2021,82,1122,64,891,0.021,18,231,0.005,43447,POINT (-87.714238 41.745398),60652-20210121
60607,01/15/2021,89,3231,75,2266,0.077,14,965,0.033,29293,POINT (-87.652727 41.876104),60607-20210115
60707,01/09/2021,14,201,10,181,0.004,4,20,0,43093,POINT (-87.808283 41.921777),60707-20210109
60633,01/21/2021,17,204,15,165,0.013,2,39,0.003,12689,POINT (-87.556037 41.653147),60633-20210121
60622,12/17/2020,135,138,135,138,0.003,0,0,0,53294,POINT (-87.681818 41.902762),60622-20201217
60644,01/11/2021,15,671,7,635,0.014,8,36,0.001,46591,POINT (-87.756863 41.881113),60644-20210111
60626,12/25/2020,0,337,0,337,0.007,0,0,0,50544,POINT (-87.669834 42.009469),60626-20201225
Unknown,01/13/2021,54,251,44,219,0,10,32,0,0,,Unknown-20210113
60642,12/21/2020,73,363,73,363,0.018,0,0,0,19716,POINT (-87.657821 41.899935),60642-20201221
60657,01/18/2021,292,5826,177,4241,0.06,115,1585,0.022,70958,POINT (-87.658216 41.939715),60657-20210118
60629,12/29/2020,81,401,81,401,0.004,0,0,0,110029,POINT (-87.711565 41.777061),60629-20201229
60618,12/20/2020,24,450,24,450,0.005,0,0,0,94907,POINT (-87.703343 41.946699),60618-20201220
60632,12/25/2020,0,154,0,154,0.002,0,0,0,89857,POINT (-87.711251 41.810038),60632-20201225
60607,12/26/2020,13,1009,13,1009,0.034,0,0,0,29293,POINT (-87.652727 41.876104),60607-20201226
60614,12/22/2020,201,1152,201,1152,0.016,0,0,0,71954,POINT (-87.652064 41.922605),60614-20201222
60612,01/08/2021,143,1241,48,1076,0.032,95,165,0.005,33735,POINT (-87.687011 41.88004),60612-20210108
60620,01/04/2021,34,305,30,300,0.004,4,5,0,67711,POINT (-87.651656 41.740873),60620-20210104
60638,12/16/2020,0,0,0,0,0,0,0,0,58669,POINT (-87.771902 41.787032),60638-20201216
60636,12/30/2020,19,74,19,74,0.002,0,0,0,30024,POINT (-87.668597 41.77599),60636-20201230
60622,12/23/2020,124,1335,124,1335,0.025,0,0,0,53294,POINT (-87.681818 41.902762),60622-20201223
60608,12/31/2020,67,912,67,912,0.011,0,0,0,80059,POINT (-87.670366 41.849879),60608-20201231
60606,12/27/2020,1,92,1,92,0.028,0,0,0,3287,POINT (-87.63676 41.882634),60606-20201227
60652,01/01/2021,0,381,0,381,0.009,0,0,0,43447,POINT (-87.714238 41.745398),60652-20210101
60610,01/04/2021,50,994,43,986,0.024,7,8,0,40548,POINT (-87.63581 41.90455),60610-20210104
60611,12/19/2020,193,895,193,895,0.027,0,0,0,33224,POINT (-87.620291 41.894734),60611-20201219
60643,01/07/2021,74,775,27,701,0.014,47,74,0.002,48887,POINT (-87.662381 41.700445),60643-20210107
60661,01/07/2021,65,630,22,570,0.055,43,60,0.006,10354,POINT (-87.644283 41.882786),60661-20210107
60622,01/18/2021,125,4863,77,3508,0.066,48,1355,0.025,53294,POINT (-87.681818 41.902762),60622-20210118
60619,12/15/2020,0,0,0,0,0,0,0,0,61207,POINT (-87.60569 41.744737),60619-20201215
60657,01/16/2021,156,5244,135,3807,0.054,21,1437,0.02,70958,POINT (-87.658216 41.939715),60657-20210116
60660,01/17/2021,27,2338,20,1995,0.045,7,343,0.008,44498,POINT (-87.666362 41.991062),60660-20210117
60649,01/02/2021,7,315,7,315,0.007,0,0,0,46633,POINT (-87.571522 41.762202),60649-20210102
60666,01/05/2021,0,0,0,0,0,0,0,0,0,POINT (-87.896371 41.979511),60666-20210105
60625,12/16/2020,4,4,4,4,0,0,0,0,79444,POINT (-87.701816 41.971155),60625-20201216
60638,01/09/2021,56,938,20,783,0.013,36,155,0.003,58669,POINT (-87.771902 41.787032),60638-20210109
60609,12/31/2020,29,336,29,336,0.006,0,0,0,60939,POINT (-87.653382 41.812017),60609-20201231
60625,12/29/2020,67,770,67,770,0.01,0,0,0,79444,POINT (-87.701816 41.971155),60625-20201229
60622,12/28/2020,62,1438,62,1438,0.027,0,0,0,53294,POINT (-87.681818 41.902762),60622-20201228
60608,12/26/2020,6,571,6,571,0.007,0,0,0,80059,POINT (-87.670366 41.849879),60608-20201226
Unknown,01/25/2021,12,704,8,614,0,4,90,0,0,,Unknown-20210125
60624,01/12/2021,35,301,28,262,0.008,7,39,0.001,34892,POINT (-87.722735 41.879417),60624-20210112
60632,12/18/2020,22,37,22,37,0,0,0,0,89857,POINT (-87.711251 41.810038),60632-20201218
60653,01/25/2021,83,1511,66,1242,0.037,17,269,0.008,33154,POINT (-87.611244 41.819261),60653-20210125
60612,01/03/2021,10,815,10,815,0.024,0,0,0,33735,POINT (-87.687011 41.88004),60612-20210103
60652,12/27/2020,0,156,0,156,0.004,0,0,0,43447,POINT (-87.714238 41.745398),60652-20201227
60642,12/26/2020,10,523,10,523,0.027,0,0,0,19716,POINT (-87.657821 41.899935),60642-20201226
60601,12/30/2020,34,400,34,400,0.027,0,0,0,15083,POINT (-87.622844 41.886262),60601-20201230
60661,01/02/2021,10,471,10,471,0.045,0,0,0,10354,POINT (-87.644283 41.882786),60661-20210102
60632,12/20/2020,6,53,6,53,0.001,0,0,0,89857,POINT (-87.711251 41.810038),60632-20201220
60602,12/19/2020,5,13,5,13,0.011,0,0,0,1145,POINT (-87.628309 41.883136),60602-20201219
60827,01/12/2021,4,24,2,20,0.001,2,4,0,28483,POINT (-87.633087 41.650765),60827-20210112
60631,01/08/2021,182,1056,111,904,0.031,71,152,0.005,29529,POINT (-87.813371 41.995019),60631-20210108
60623,01/07/2021,50,676,40,660,0.008,10,16,0,81283,POINT (-87.717446 41.850321),60623-20210107
60621,01/03/2021,0,180,0,180,0.006,0,0,0,28018,POINT (-87.638812 41.776931),60621-20210103
60653,12/19/2020,21,58,21,58,0.002,0,0,0,33154,POINT (-87.611244 41.819261),60653-20201219
60631,01/13/2021,82,1339,60,1026,0.035,22,313,0.011,29529,POINT (-87.813371 41.995019),60631-20210113
60645,12/26/2020,5,288,5,288,0.006,0,0,0,47270,POINT (-87.695049 42.008927),60645-20201226
Unknown,01/20/2021,72,521,48,441,0,24,80,0,0,,Unknown-20210120
60618,01/16/2021,110,3700,94,2797,0.029,16,903,0.01,94907,POINT (-87.703343 41.946699),60618-20210116
60626,01/05/2021,149,1000,148,997,0.02,1,3,0,50544,POINT (-87.669834 42.009469),60626-20210105
60638,01/14/2021,87,1291,72,985,0.017,15,306,0.005,58669,POINT (-87.771902 41.787032),60638-20210114
60610,01/15/2021,89,2253,78,1606,0.04,11,647,0.016,40548,POINT (-87.63581 41.90455),60610-20210115
60655,01/11/2021,79,1130,27,834,0.029,52,296,0.01,28569,POINT (-87.701434 41.696456),60655-20210111
60640,12/19/2020,96,314,96,314,0.005,0,0,0,69363,POINT (-87.662232 41.971888),60640-20201219
60636,01/10/2021,1,172,0,158,0.005,1,14,0,30024,POINT (-87.668597 41.77599),60636-20210110
60657,12/28/2020,119,1618,119,1618,0.023,0,0,0,70958,POINT (-87.658216 41.939715),60657-20201228
60827,01/25/2021,3,51,2,44,0.002,1,7,0,28483,POINT (-87.633087 41.650765),60827-20210125
60602,01/10/2021,2,79,1,64,0.056,1,15,0.013,1145,POINT (-87.628309 41.883136),60602-20210110
60652,12/20/2020,12,63,12,63,0.001,0,0,0,43447,POINT (-87.714238 41.745398),60652-20201220
60661,12/21/2020,56,270,56,270,0.026,0,0,0,10354,POINT (-87.644283 41.882786),60661-20201221
60626,12/21/2020,61,231,61,231,0.005,0,0,0,50544,POINT (-87.669834 42.009469),60626-20201221
60660,01/02/2021,15,605,15,605,0.014,0,0,0,44498,POINT (-87.666362 41.991062),60660-20210102
60661,12/23/2020,27,340,27,340,0.033,0,0,0,10354,POINT (-87.644283 41.882786),60661-20201223
60646,12/17/2020,13,13,13,13,0,0,0,0,28569,POINT (-87.761826 41.993931),60646-20201217
60606,12/17/2020,7,7,7,7,0.002,0,0,0,3287,POINT (-87.63676 41.882634),60606-20201217
60644,12/31/2020,8,213,8,213,0.005,0,0,0,46591,POINT (-87.756863 41.881113),60644-20201231
60660,12/20/2020,8,184,8,184,0.004,0,0,0,44498,POINT (-87.666362 41.991062),60660-20201220
60606,01/01/2021,0,123,0,123,0.037,0,0,0,3287,POINT (-87.63676 41.882634),60606-20210101
60639,01/01/2021,0,378,0,378,0.004,0,0,0,88204,POINT (-87.75531 41.920609),60639-20210101
60608,01/05/2021,69,1102,65,1092,0.014,4,10,0,80059,POINT (-87.670366 41.849879),60608-20210105
60632,01/08/2021,47,651,34,613,0.007,13,38,0,89857,POINT (-87.711251 41.810038),60632-20210108
60622,01/07/2021,279,2855,86,2619,0.049,193,236,0.004,53294,POINT (-87.681818 41.902762),60622-20210107
60609,01/15/2021,36,965,28,789,0.013,8,176,0.003,60939,POINT (-87.653382 41.812017),60609-20210115
60619,01/16/2021,25,897,24,788,0.013,1,109,0.002,61207,POINT (-87.60569 41.744737),60619-20210116
60643,12/18/2020,58,85,58,85,0.002,0,0,0,48887,POINT (-87.662381 41.700445),60643-20201218
60649,12/16/2020,0,0,0,0,0,0,0,0,46633,POINT (-87.571522 41.762202),60649-20201216
60666,01/26/2021,1,4,1,4,0,0,0,0,0,POINT (-87.896371 41.979511),60666-20210126
60606,01/18/2021,7,286,2,191,0.058,5,95,0.029,3287,POINT (-87.63676 41.882634),60606-20210118
60602,01/03/2021,3,47,3,47,0.041,0,0,0,1145,POINT (-87.628309 41.883136),60602-20210103
60632,01/09/2021,36,687,26,639,0.007,10,48,0.001,89857,POINT (-87.711251 41.810038),60632-20210109
60625,01/13/2021,195,2655,93,2074,0.026,102,581,0.007,79444,POINT (-87.701816 41.971155),60625-20210113
60656,01/19/2021,45,834,34,615,0.022,11,219,0.008,28218,POINT (-87.817934 41.974566),60656-20210119
60637,01/14/2021,61,1467,46,1128,0.024,15,339,0.007,47300,POINT (-87.604053 41.780991),60637-20210114
60653,01/08/2021,58,589,30,533,0.016,28,56,0.002,33154,POINT (-87.611244 41.819261),60653-20210108
60629,12/24/2020,16,277,16,277,0.003,0,0,0,110029,POINT (-87.711565 41.777061),60629-20201224
60628,01/01/2021,1,232,1,232,0.004,0,0,0,64254,POINT (-87.621537 41.694192),60628-20210101
60649,12/22/2020,17,80,17,80,0.002,0,0,0,46633,POINT (-87.571522 41.762202),60649-20201222
60655,12/27/2020,0,379,0,379,0.013,0,0,0,28569,POINT (-87.701434 41.696456),60655-20201227
60645,12/17/2020,16,21,16,21,0,0,0,0,47270,POINT (-87.695049 42.008927),60645-20201217
60633,01/18/2021,10,147,8,120,0.009,2,27,0.002,12689,POINT (-87.556037 41.653147),60633-20210118
60641,12/19/2020,56,200,56,200,0.003,0,0,0,69880,POINT (-87.746791 41.946682),60641-20201219
60641,12/21/2020,87,302,87,302,0.004,0,0,0,69880,POINT (-87.746791 41.946682),60641-20201221
60624,01/02/2021,6,124,6,124,0.004,0,0,0,34892,POINT (-87.722735 41.879417),60624-20210102
60617,12/28/2020,40,242,40,242,0.003,0,0,0,83553,POINT (-87.556897 41.721257),60617-20201228
60630,01/04/2021,72,752,70,750,0.013,2,2,0,56433,POINT (-87.759611 41.971261),60630-20210104
60623,12/23/2020,34,147,34,147,0.002,0,0,0,81283,POINT (-87.717446 41.850321),60623-20201223
60656,02/05/2021,132,2106,114,1656,0.059,18,450,0.016,28218,POINT (-87.817934 41.974566),60656-20210205
60641,01/05/2021,75,895,75,895,0.013,0,0,0,69880,POINT (-87.746791 41.946682),60641-20210105
60666,02/06/2021,0,14,0,14,0,0,0,0,0,POINT (-87.896371 41.979511),60666-20210206
60618,12/15/2020,0,0,0,0,0,0,0,0,94907,POINT (-87.703343 41.946699),60618-20201215
60655,12/15/2020,0,0,0,0,0,0,0,0,28569,POINT (-87.701434 41.696456),60655-20201215
60637,12/30/2020,122,572,122,572,0.012,0,0,0,47300,POINT (-87.604053 41.780991),60637-20201230
60661,01/17/2021,6,1062,4,721,0.07,2,341,0.033,10354,POINT (-87.644283 41.882786),60661-20210117
60610,12/31/2020,24,899,24,899,0.022,0,0,0,40548,POINT (-87.63581 41.90455),60610-20201231
60652,01/23/2021,38,1234,36,993,0.023,2,241,0.006,43447,POINT (-87.714238 41.745398),60652-20210123
60827,12/24/2020,1,7,1,7,0,0,0,0,28483,POINT (-87.633087 41.650765),60827-20201224
60608,12/21/2020,98,342,98,342,0.004,0,0,0,80059,POINT (-87.670366 41.849879),60608-20201221
60656,01/16/2021,22,762,18,558,0.02,4,204,0.007,28218,POINT (-87.817934 41.974566),60656-20210116
60612,12/19/2020,52,209,52,209,0.006,0,0,0,33735,POINT (-87.687011 41.88004),60612-20201219
60652,01/11/2021,32,650,12,570,0.013,20,80,0.002,43447,POINT (-87.714238 41.745398),60652-20210111
60644,01/15/2021,24,921,19,852,0.018,5,69,0.001,46591,POINT (-87.756863 41.881113),60644-20210115
60637,12/16/2020,2,2,2,2,0,0,0,0,47300,POINT (-87.604053 41.780991),60637-20201216
60614,02/03/2021,296,9490,221,7051,0.098,75,2439,0.034,71954,POINT (-87.652064 41.922605),60614-20210203
60616,02/07/2021,52,6461,37,4951,0.091,15,1510,0.028,54197,POINT (-87.629531 41.844869),60616-20210207
60623,12/24/2020,8,155,8,155,0.002,0,0,0,81283,POINT (-87.717446 41.850321),60623-20201224
60631,12/29/2020,44,407,44,407,0.014,0,0,0,29529,POINT (-87.813371 41.995019),60631-20201229
60707,01/05/2021,11,144,11,143,0.003,0,1,0,43093,POINT (-87.808283 41.921777),60707-20210105
60616,12/27/2020,0,658,0,658,0.012,0,0,0,54197,POINT (-87.629531 41.844869),60616-20201227
60651,01/20/2021,99,917,63,741,0.012,36,176,0.003,63492,POINT (-87.741017 41.901964),60651-20210120
60602,01/20/2021,10,160,8,117,0.102,2,43,0.038,1145,POINT (-87.628309 41.883136),60602-20210120
60661,02/08/2021,19,1864,13,1219,0.118,6,645,0.062,10354,POINT (-87.644283 41.882786),60661-20210208
60646,01/03/2021,5,477,5,477,0.017,0,0,0,28569,POINT (-87.761826 41.993931),60646-20210103
